2008,27,59,45,44,45,50,52,60,77,55,73,40,60,80,59,74,78,86,42,51,64,73,53,78,88,58,55,79,91,59,78,70,62,65,80,90,72,74,79,33,54,65,85,82,49,58,51,61,88,80,73,68,63,42,62,74,84,102,85,67,48,56,72,61,76,75,70,61,67,88,93,82,71,63,50,73,94,77,82,101,43,32,51,66,75,71,78,56,58,39,76,64,80,81,61,35,33,70,68,66,53,45,39,29,42,42,40,48,57,42,28,52,49,36,23,21,17,15,23,31,14,17,23,11,18,28,23,13,16,17,10,19,11,23,24,22,18,5,7,13,19,17,27,11,15,17,15,11,26,13,13,6,14,12,12,22,17,12,10,14,15,13,23,24,13,6,5,15,10,12,22,14,12,9,16,11,23,26,16,7,7,12,18,18,13,14,8,11,17,18,11,17,9,6,8,19,16,14,20,12,12,10,18,15,22,20,12,11,13,18,9,11,16,21,3,7,6,10,16,13,9,6,5,12,17,14,15,11,11,10,14,8,14,11,10,11,6,14,10,16,9,14,8,9,7,13,13,31,20,6,8,9,9,11,21,15,6,18,22,20,31,27,36,20,12,10,20,16,10,13,7,14,20,21,21,23,23,15,16,21,17,37,15,19,5,13,10,12,26,18,8,5,13,26,34,24,24,12,8,9,23,18,19,18,17,9,8,17,23,21,10,14,8,15,14,20,16,27,14,9,16,11,12,17,11,10,17,12,19,23,20,6,13,17,21,20,26,22,23,12,17,13,14,15,21,20,14,7,14,24,6,13,7,8,3,10,7,15,6,3,9,5,4,4,4,7
2009,3,7,9,4,18,12,13,21,10,11,11,10,12,14,12,10,10,11,10,11,22,16,9,7,21,18,19,12,22,14,8,18,14,14,12,8,26,14,15,12,16,36,22,9,8,15,19,10,19,23,10,11,23,16,15,17,22,12,8,6,22,29,16,18,10,8,11,13,18,19,13,15,1,12,24,22,30,16,15,15,12,29,14,19,16,10,15,23,17,22,22,13,8,16,6,19,19,13,20,15,7,9,16,9,17,22,27,16,18,7,19,20,14,15,7,10,12,14,19,17,5,9,17,19,13,20,12,12,7,11,20,16,22,17,20,13,8,16,18,25,9,25,6,11,11,22,16,18,16,11,10,11,23,15,28,8,10,15,27,20,21,8,14,8,8,12,11,20,18,10,7,8,20,11,18,22,9,11,7,21,9,10,11,6,4,9,11,15,13,12,11,6,11,15,17,4,10,16,3,4,9,12,19,20,19,8,18,5,12,14,14,11,6,5,12,13,11,8,14,8,11,11,9,11,11,13,8,7,14,15,10,11,6,6,11,10,13,18,5,14,2,7,8,4,15,8,10,18,8,12,15,11,15,10,6,10,13,10,14,18,12,12,12,11,6,10,13,10,14,18,12,12,12,14,8,5,13,16,20,24,17,18,14,7,26,21,26,21,11,7,16,17,19,14,19,9,9,9,18,7,17,14,8,11,10,17,25,18,14,22,6,8,19,19,29,17,9,7,10,18,9,11,20,8,9,7,9,25,13,11,10,5,6,11,17,15,14,11,10,15,12,15,16,14,16,11,29,13,16,12,8,22,9,10,8,10,9,7,3,8,3,13,1,10,11
2010,9,7,8,8,15,15,11,13,15,13,16,5,19,16,18,11,6,8,13,8,9,17,14,14,20,10,18,12,10,9,13,16,12,8,12,16,12,14,32,7,20,16,7,8,9,18,13,8,20,18,20,11,10,11,8,14,16,12,18,16,17,12,9,13,10,4,29,7,14,14,21,9,11,16,18,20,15,14,9,16,20,16,18,15,14,13,16,18,13,10,15,13,8,10,12,11,9,12,10,9,19,12,22,23,20,18,11,9,18,18,14,19,16,7,8,14,12,17,12,16,17,17,17,14,15,7,16,14,11,22,8,12,17,11,13,16,23,7,6,10,20,14,11,13,14,9,16,5,4,7,9,9,9,9,14,13,8,12,15,13,11,2,16,16,10,16,8,13,12,6,9,16,16,17,9,10,10,9,9,9,10,13,6,6,3,4,9,8,9,8,1,5,3,5,5,10,7,9,7,8,5,12,15,10,10,7,12,5,10,7,6,5,8,7,10,8,9,11,6,12,13,10,13,11,15,2,7,11,8,15,13,10,7,6,11,14,11,15,11,6,2,12,7,10,10,10,7,4,11,10,8,10,9,6,11,8,14,23,17,6,7,6,8,3,13,18,10,13,14,16,12,13,10,20,10,13,28,16,19,13,11,4,11,5,13,11,23,13,7,11,12,16,14,29,28,6,16,23,13,21,22,27,9,12,7,16,12,9,11,7,11,20,12,16,19,6,7,15,24,15,16,17,14,8,9,12,19,13,17,11,8,12,19,22,19,16,13,18,12,7,18,19,13,17,14,14,17,29,28,19,12,12,16,3,6,9,7,4,5,8,5,15,6,4,7
2011,7,4,8,6,13,13,10,7,6,17,18,13,17,7,5,14,9,20,9,12,15,10,7,11,22,9,17,19,7,18,19,10,5,23,15,11,7,24,14,17,17,12,3,14,19,20,10,12,8,11,14,12,22,27,16,16,10,13,28,12,14,12,9,8,18,29,18,18,16,10,13,15,22,29,17,11,9,4,11,13,22,20,7,11,7,11,11,13,22,20,13,6,10,12,20,11,13,24,10,8,18,19,23,15,15,8,18,21,16,11,8,15,8,5,19,12,12,14,16,19,23,9,19,12,17,14,12,10,17,13,8,13,13,14,11,19,18,11,15,12,11,11,21,11,17,21,11,6,7,14,15,13,14,11,8,11,18,18,19,10,12,4,2,17,9,17,14,10,12,9,19,6,9,15,4,2,5,10,10,5,4,8,5,5,13,7,13,6,16,1,11,14,5,11,5,9,7,9,3,9,7,12,7,7,16,6,11,17,24,10,19,17,22,21,19,21,19,3,5,8,12,13,18,12,6,5,16,10,5,3,7,8,10,10,10,8,6,10,9,8,5,10,9,7,10,11,6,6,7,8,6,6,5,12,13,7,18,5,6,3,10,23,11,13,10,6,10,12,13,17,15,17,11,13,13,18,18,15,12,19,6,13,14,14,13,11,9,10,8,18,16,17,17,15,13,14,12,19,11,11,12,10,6,8,10,24,11,10,8,18,11,4,19,9,18,5,13,22,16,17,7,9,9,18,12,18,14,12,7,12,16,19,20,14,21,17,16,15,17,17,28,19,12,12,19,16,15,30,19,18,5,11,6,4,14,7,24,24,24,23,7,10,8,10,7
2012,5,14,11,11,15,12,3,17,24,29,17,34,17,10,12,20,19,15,24,29,15,36,26,33,37,33,18,14,15,33,33,25,29,33,10,65,39,49,28,32,35,15,30,40,32,26,24,27,9,21,33,35,30,25,12,11,9,23,12,19,21,13,13,15,16,13,14,17,18,15,12,15,15,17,21,13,12,14,8,13,13,24,15,9,13,18,11,26,18,10,16,12,9,21,20,8,15,11,13,28,21,20,20,19,13,7,28,21,20,23,25,12,16,16,30,17,8,12,20,19,18,31,11,16,9,10,18,18,16,27,21,15,10,16,20,12,9,14,13,8,17,17,16,16,15,11,6,14,18,16,18,13,5,6,11,22,32,7,9,16,12,10,14,19,18,14,7,9,7,21,14,25,11,7,11,14,22,18,26,14,9,16,13,18,12,13,9,15,15,11,15,12,18,18,19,10,23,17,22,19,13,17,17,19,20,23,22,22,11,13,14,15,10,13,20,14,9,5,10,14,19,17,10,16,11,17,9,11,14,14,9,6,8,20,13,12,18,8,11,14,18,18,11,15,9,20,14,11,14,8,16,18,10,16,10,11,9,7,18,11,9,11,6,19,14,11,10,17,25,17,21,10,7,4,15,13,24,12,17,9,12,21,22,20,13,8,4,7,17,20,12,26,15,16,17,27,10,22,23,17,17,10,14,14,18,8,21,13,17,12,20,13,23,14,15,21,17,15,19,11,13,11,14,19,24,17,11,10,10,15,14,19,14,18,18,8,7,25,11,13,24,16,10,14,12,19,20,24,13,14,5,10,11,12,11,12,7,12,10,6,16,16,21,9,9,13
2013,7,10,10,14,12,11,12,26,19,16,6,6,12,13,18,16,12,11,18,10,19,17,14,13,13,11,10,22,13,16,14,19,19,10,13,12,12,12,16,21,5,14,9,16,11,12,6,14,17,9,4,15,10,13,13,9,14,12,13,21,7,7,11,10,10,13,11,8,21,11,21,16,22,9,12,10,10,7,12,11,17,5,11,5,11,7,9,14,8,13,13,14,11,16,5,9,5,21,16,23,15,15,7,15,11,10,17,19,20,11,9,19,20,25,16,10,10,15,15,9,12,18,10,8,16,21,6,12,27,11,10,8,13,12,11,16,11,11,9,9,16,14,22,12,9,12,9,23,21,20,9,4,7,15,18,9,12,7,9,9,20,8,10,18,12,9,15,12,12,7,11,10,7,5,11,10,15,20,15,4,9,12,19,12,5,13,9,7,11,12,10,12,11,4,10,18,11,12,8,7,2,13,11,8,2,11,8,3,6,9,7,5,4,7,10,11,12,9,7,9,116,19,20,26,22,29,12,20,14,18,27,32,24,33,27,17,26,21,19,27,23,16,16,20,33,33,34,30,23,18,20,26,37,30,37,40,19,26,49,62,51,40,34,23,21,45,45,48,33,30,18,43,56,54,48,49,53,29,38,58,57,78,63,66,30,29,61,58,78,55,39,36,47,59,65,72,72,45,38,31,62,64,69,59,66,46,48,91,96,83,61,68,40,42,81,67,81,71,73,47,56,62,80,82,111,72,63,55,106,83,64,59,36,48,58,85,85,89,82,61,56,58,80,93,84,72,69,62,42,62,60,51,39,52,18,23,28,26,19,29,21,24,38,48,26
2014,17,44,53,47,47,47,56,64,72,56,50,41,97,91,82,86,61,50,70,65,108,99,100,78,59,62,98,78,101,102,93,32,53,85,95,87,64,80,40,65,110,79,93,68,59,45,44,106,95,96,73,52,67,82,103,91,81,93,79,58,100,109,116,97,80,72,54,57,92,95,97,91,71,62,60,102,86,105,86,85,50,79,78,94,89,100,82,53,76,99,132,100,113,95,65,94,107,144,110,113,72,53,62,113,101,87,93,81,62,67,104,124,100,117,81,62,73,106,127,124,106,76,51,77,123,100,132,86,85,79,74,123,106,97,89,81,56,70,89,101,101,115,59,44,61,75,94,91,108,86,33,143,130,113,106,79,81,43,49,101,64,71,64,75,50,49,72,84,88,57,55,33,49,53,76,69,70,49,38,38,70,65,71,76,60,45,60,87,74,62,86,51,64,52,86,79,87,56,56,27,40,69,69,73,76,69,36,56,72,78,63,75,55,36,57,70,61,65,74,46,26,37,64,50,67,52,52,38,48,54,74,58,75,61,41,42,137,108,70,79,85,59,69,92,89,119,103,84,83,110,101,96,103,103,80,44,70,85,97,92,91,78,50,82,93,131,124,126,72,46,54,116,118,110,109,85,58,73,119,150,107,90,83,46,80,96,128,136,148,78,60,79,101,102,97,91,67,59,61,123,109,123,119,68,45,75,149,142,102,113,82,67,76,121,109,121,91,112,78,84,129,104,126,116,101,60,97,132,148,110,72,73,80,69,135,138,129,112,94,73,76,118,119,112,112,93,72,75,93,72,83,85,51,45,36,48,40,32,32,49,38,36,43,51,59
2015,38,53,45,53,78,78,72,91,82,56,71,93,81,97,85,85,67,75,72,108,111,97,86,76,77,106,129,85,104,116,51,91,103,107,119,109,82,47,73,137,105,113,133,74,130,75,133,98,110,121,90,73,61,119,106,141,97,107,52,85,125,99,87,112,92,52,77,116,99,104,107,82,56,69,106,121,114,149,102,60,87,124,99,135,117,78,65,93,130,122,103,98,62,72,59,116,108,114,100,117,59,78,141,137,135,190,95,72,101,161,130,115,128,117,80,120,141,160,126,126,94,79,110,149,122,129,130,85,0,97,126,135,133,127,84,76,96,131,133,134,106,87,64,73,0,0,129,97,91,57,67,97,89,91,108,72,49,76,106,92,106,88,85,49,68,91,67,95,80,65,50,47,91,84,75,68,59,21,48,64,81,74,63,45,31,40,64,88,66,185,69,44,38,66,70,71,64,40,33,55,58,87,78,70,35,43,32,62,58,78,57,49,21,37,43,61,70,65,58,42,25,47,63,48,64,39,28,40,65,67,59,63,76,30,32,64,66,49,64,44,27,49,44,59,68,71,73,41,28,70,66,93,99,55,49,62,93,135,111,101,80,69,65,90,96,106,94,89,46,72,117,123,119,109,87,49,69,119,112,109,107,82,60,60,100,122,138,138,96,70,99,101,97,86,86,97,71,112,126,101,110,136,67,47,57,118,127,121,109,72,68,76,114,113,108,105,97,74,87,115,110,126,105,67,55,77,118,122,104,75,51,49,92,115,120,131,91,97,75,93,108,117,140,120,96,82,88,119,123,127,91,71,25,56,60,45,29,25,24,19,27,63,37,56,22
2016,24,35,50,57,89,84,99,64,43,65,91,93,113,100,89,44,65,118,94,95,98,67,60,84,115,134,97,107,84,67,89,115,115,114,103,86,43,68,120,135,134,108,74,54,76,100,104,101,97,89,57,74,116,122,84,104,93,66,87,111,114,129,110,103,71,80,124,111,120,93,92,78,84,129,111,94,123,75,61,61,126,94,102,90,47,68,61,95,116,127,111,101,55,76,124,120,114,119,110,68,82,94,135,119,133,88,80,97,128,120,132,121,121,66,64,142,152,129,135,103,58,104,127,148,104,122,103,63,68,103,113,123,102,82,69,63,93,91,122,95,101,48,80,136,135,104,123,71,47,58,61,114