2008,85,150,170,179,114,140,222,219,202,211,235,122,154,251,243,212,199,215,105,168,215,269,287,263,174,120,157,227,236,257,221,193,164,125,210,215,222,246,212,139,156,246,234,252,273,172,148,174,216,244,288,236,215,150,194,283,304,328,281,200,161,172,249,283,318,312,222,164,235,302,256,265,253,237,179,162,293,223,278,223,163,145,136,252,262,224,265,173,130,171,261,280,242,240,203,116,161,321,264,273,253,212,147,193,324,259,215,236,207,165,199,268,296,320,243,231,180,215,329,297,299,265,228,172,253,314,308,244,248,228,153,170,247,303,288,249,208,157,141,210,235,221,195,179,103,137,187,196,178,200,169,121,164,198,217,215,202,151,135,159,219,606,964,1161,976,110,169,184,200,631,626,130,90,143,211,207,209,219,155,78,125,177,150,157,199,131,98,129,197,156,171,634,228,116,216,613,391,191,154,153,119,97,159,200,217,174,138,101,125,162,164,153,183,131,125,128,180,178,159,173,123,108,110,180,159,180,168,127,90,150,174,197,169,214,143,107,132,260,257,203,255,218,117,138,203,245,217,268,234,139,174,279,265,215,212,160,106,177,276,257,243,208,192,121,113,234,269,268,220,218,140,159,275,273,289,239,197,136,212,298,299,257,264,260,187,169,314,286,366,320,282,185,211,382,383,342,279,219,147,210,319,297,340,306,239,139,208,302,282,250,278,249,145,204,301,294,321,307,241,178,211,300,307,233,247,206,148,201,259,287,265,221,160,141,171,296,316,248,254,220,150,194,320,282,324,268,198,145,196,209,186,209,228,139,87,115,128,97,86,72,70,85,75,130,99,106
2009,96,97,121,126,225,178,151,219,179,106,145,213,243,232,258,187,143,166,228,236,225,193,217,108,164,202,255,246,203,219,126,166,240,240,300,394,291,140,156,242,258,288,248,210,146,162,262,237,312,307,213,189,207,288,330,235,280,222,214,188,307,300,274,290,264,188,209,280,283,256,301,269,138,221,308,339,278,283,215,196,204,318,268,284,273,303,172,231,293,312,268,300,219,140,165,246,276,257,226,195,141,133,233,238,222,257,199,148,196,306,318,401,315,242,143,190,269,286,253,289,204,159,208,291,315,279,234,197,146,211,310,644,525,292,228,162,185,241,247,244,252,163,108,162,192,233,221,223,153,126,148,202,212,172,200,175,133,123,205,222,212,169,144,100,138,185,185,177,193,158,105,152,172,198,155,184,138,119,131,187,161,151,171,122,91,108,185,204,162,151,126,124,114,186,179,174,159,146,112,118,172,166,166,173,143,101,113,199,372,182,159,175,115,136,172,198,193,153,148,125,117,139,205,174,142,131,90,99,187,181,200,151,137,89,144,181,208,257,260,168,189,381,343,237,290,206,233,133,166,231,275,239,230,181,138,199,264,306,337,270,201,128,184,283,138,199,264,306,337,270,201,128,184,323,264,138,255,337,353,312,314,253,198,234,365,335,339,335,248,179,191,341,357,353,333,304,208,241,435,323,394,304,258,150,170,299,356,344,270,225,224,214,289,392,299,330,295,205,206,363,300,293,265,235,160,159,254,328,220,187,161,134,185,240,264,237,236,267,232,227,300,325,316,319,221,171,202,281,304,300,272,213,106,123,169,141,161,87,78,127,98,131,143,159,107
2010,95,99,119,189,163,208,179,167,159,163,216,240,245,254,227,142,172,200,277,265,250,237,223,223,287,276,256,310,261,187,186,290,262,251,294,232,156,198,298,246,297,329,212,146,163,255,306,267,273,241,175,198,330,326,238,259,227,171,188,316,317,315,294,256,182,204,265,270,234,254,205,198,239,297,1387,592,395,332,242,254,337,402,468,362,327,194,281,415,267,267,274,170,192,203,270,268,305,312,237,157,217,307,315,297,275,249,160,312,364,360,296,281,256,255,217,333,323,335,286,289,188,268,365,384,382,326,301,170,222,392,441,259,213,191,176,177,228,159,175,225,183,153,180,264,210,219,187,139,124,201,226,241,197,196,217,149,213,208,218,218,156,178,213,216,208,124,120,191,173,122,130,163,141,142,160,106,102,97,139,147,144,164,147,95,103,124,131,147,131,147,104,90,135,141,122,117,106,118,117,127,133,127,167,169,197,116,234,172,207,170,169,126,132,203,197,193,203,210,133,160,207,218,209,234,166,125,123,196,185,210,205,160,147,143,212,221,209,231,168,148,192,225,265,275,260,210,152,157,248,283,271,267,237,191,191,294,327,371,292,270,215,273,320,290,315,288,221,235,190,356,322,294,323,224,170,250,332,382,361,379,296,182,208,281,330,358,367,273,205,242,393,350,312,407,298,188,245,362,327,370,275,264,143,206,360,354,358,330,283,251,253,329,416,384,321,261,196,228,344,377,323,266,263,192,231,342,352,312,260,205,215,233,373,383,328,278,243,202,234,359,361,332,340,292,231,280,431,385,363,336,255,160,173,226,198,169,190,100,77,95,137,128,130,130,138
2011,411,175,235,211,221,211,231,169,199,277,274,300,251,296,168,219,232,261,314,263,226,152,251,342,330,271,339,229,142,162,245,275,246,220,222,187,196,276,294,277,301,249,146,184,262,300,314,321,223,142,335,279,277,266,302,241,175,226,341,288,309,283,215,123,230,331,280,292,286,251,151,219,298,278,263,289,235,165,198,302,300,256,251,192,183,230,308,318,262,260,222,132,167,264,248,267,267,210,183,212,390,271,285,258,217,126,185,261,251,237,267,182,169,199,312,986,391,375,198,148,259,407,321,286,301,213,136,183,245,297,268,217,175,159,160,249,237,239,198,172,137,163,205,208,210,188,174,107,131,174,205,193,197,145,109,137,158,186,181,186,164,132,154,214,226,185,169,138,97,172,145,148,159,174,131,105,128,185,156,163,158,146,100,126,119,139,161,164,133,99,117,161,175,147,172,108,120,117,169,155,164,159,133,100,130,153,148,165,172,113,89,94,124,155,175,169,136,88,103,142,163,156,157,120,110,134,111,139,150,121,134,121,109,161,137,136,142,152,120,133,168,163,159,149,122,91,123,153,164,213,223,195,129,133,196,214,208,192,162,145,160,239,198,229,293,191,119,135,240,246,249,262,320,180,215,307,289,319,298,223,196,244,324,324,343,291,178,168,175,301,1887,429,351,213,148,174,302,300,391,324,230,170,220,298,321,443,323,264,175,234,340,333,355,335,245,172,222,319,333,275,318,252,143,189,250,248,232,152,148,141,194,229,294,283,252,205,180,209,306,323,304,244,277,186,216,320,332,303,290,276,125,148,230,194,153,133,72,72,72,88,106,122,111,130,88
2012,84,149,181,182,180,194,124,161,247,284,294,277,242,140,169,230,256,310,264,216,147,179,245,295,280,237,201,129,189,303,275,215,290,215,152,202,269,231,294,277,218,150,197,318,315,252,334,221,123,189,246,244,303,249,223,175,186,317,322,270,251,238,164,226,304,342,319,287,259,159,196,311,266,259,233,175,167,175,262,285,256,255,190,161,181,297,280,236,245,200,155,174,287,262,213,211,142,136,187,215,271,254,237,171,137,177,297,224,273,256,208,162,193,256,313,249,293,222,172,234,339,318,291,336,236,155,239,454,303,291,242,214,151,162,282,288,221,232,161,129,161,240,209,211,198,164,164,122,215,204,203,175,197,182,159,235,256,221,158,171,127,132,244,212,178,222,159,162,181,210,179,168,135,157,121,145,180,160,161,115,117,113,105,146,142,147,141,148,174,127,146,126,185,172,133,153,114,166,178,155,187,185,165,168,171,152,177,161,137,93,96,161,149,158,148,129,96,117,157,155,167,148,126,102,143,149,149,166,141,158,117,108,153,192,174,196,183,96,140,213,216,208,200,148,101,182,191,217,241,217,195,155,220,306,245,274,249,229,139,202,269,222,284,306,273,176,224,319,341,278,274,267,218,216,346,373,333,338,258,182,264,336,383,409,376,284,325,255,357,347,345,366,354,207,239,395,363,356,386,299,188,216,318,328,294,278,273,202,243,338,365,284,343,262,153,204,322,365,356,345,276,230,213,335,325,270,231,180,189,219,352,383,367,363,284,162,269,453,387,439,348,326,194,247,425,362,436,346,293,198,221,358,340,502,398,388,295,347,337,372,430,386,343,288,257,303
2013,390,357,382,439,313,382,416,421,477,389,272,193,218,324,348,308,333,244,187,190,245,279,336,319,252,147,225,312,291,316,294,218,167,217,326,378,354,362,297,229,249,418,296,310,294,250,202,191,395,407,368,357,252,238,255,382,356,322,338,315,172,220,390,404,336,342,306,175,221,368,379,359,319,299,235,226,346,354,331,364,209,163,210,302,296,288,259,214,135,194,266,335,296,451,313,163,230,340,281,322,289,282,199,209,336,312,286,330,224,169,290,354,353,336,296,267,205,286,460,647,460,392,278,222,340,492,313,306,312,230,172,185,259,273,278,272,193,155,163,218,253,246,219,173,132,145,189,223,232,255,196,158,170,397,270,341,271,208,247,199,222,258,216,210,173,171,154,202,235,225,221,161,131,145,201,206,174,171,205,117,185,225,238,178,142,155,131,154,211,169,181,170,151,132,149,164,216,150,162,207,127,162,191,162,65,160,140,125,133,186,149,159,166,158,132,129,189,229,164,188,130,119,140,175,169,158,157,154,143,140,204,168,157,232,136,100,127,150,153,152,153,166,73,134,160,185,205,187,192,124,165,191,230,209,206,173,127,161,218,224,200,226,180,147,187,316,230,338,244,220,205,218,259,361,329,268,259,181,200,311,350,330,262,257,184,201,357,321,299,348,280,187,216,391,365,315,319,296,183,206,300,315,282,278,231,184,207,319,281,315,267,316,165,215,272,309,308,282,263,191,218,366,374,294,307,211,149,170,281,268,220,155,163,181,192,280,304,305,285,263,187,233,364,415,370,288,251,136,171,219,300,254,241,146,92,108,121,71,62,75,97,119,108,88,71
2014,78,135,127,116,116,116,204,174,213,158,137,168,211,224,269,247,201,118,161,201,215,220,209,166,119,165,200,248,226,207,149,140,152,218,241,229,265,209,155,193,232,227,218,214,216,151,201,290,302,306,276,225,180,249,271,267,246,226,200,137,194,259,258,288,223,233,174,205,341,327,352,255,197,161,152,214,259,268,280,224,163,196,220,298,309,271,258,195,216,303,291,267,236,205,171,199,320,221,297,272,342,175,169,298,241,253,219,160,159,146,245,300,256,289,216,160,225,318,290,290,287,242,173,188,339,294,267,271,233,179,224,267,251,238,237,230,160,189,205,263,235,228,152,125,174,192,177,186,166,183,133,173,206,227,193,221,195,128,156,190,195,176,154,148,113,116,171,151,169,163,175,105,124,153,175,174,149,124,105,124,176,135,135,112,125,106,113,162,187,136,146,163,99,149,192,168,169,159,165,103,115,150,158,148,172,143,129,143,175,167,174,148,144,107,126,185,149,148,150,127,148,111,162,160,158,188,162,103,137,197,175,170,152,156,95,161,137,168,151,166,152,103,167,173,235,220,206,186,143,176,246,197,208,247,206,124,146,231,210,210,211,246,128,160,268,277,290,254,189,137,197,269,265,263,327,230,168,209,617,535,433,368,274,204,235,335,316,304,260,238,152,227,323,273,298,304,240,145,194,301,285,253,276,221,158,199,308,337,252,283,238,196,224,328,248,241,266,214,174,180,283,223,257,284,183,163,165,250,260,213,180,172,119,142,239,217,258,191,171,125,176,195,259,263,277,179,137,190,229,220,181,168,133,123,114,105,123,89,84,87,81,99,110,116,85
2015,84,121,134,126,158,171,161,183,196,149,128,183,196,196,180,123,92,115,176,181,174,198,162,120,131,174,163,191,200,169,107,118,179,143,169,224,162,126,160,186,187,176,181,131,99,122,181,162,177,172,152,137,141,208,195,205,189,153,133,164,207,227,203,274,175,137,146,207,210,191,189,172,116,124,188,184,208,196,156,139,138,246,212,197,199,164,121,113,208,195,166,157,112,92,113,159,206,201,191,158,116,150,204,250,209,206,151,126,168,196,236,259,171,163,142,134,216,220,204,173,170,129,182,256,226,222,205,174,0,151,264,256,193,205,161,157,142,185,183,185,163,145,109,123,0,0,153,142,143,125,151,181,184,172,158,156,116,115,145,159,155,157,86,92,104,144,178,148,156,130,81,92,144,139,125,151,97,62,72,94,126,102,143,98,89,97,110,154,125,111,114,90,92,110,106,96,128,105,70,86,130,113,119,126,96,75,89,88,143,132,100,99,63,106,94,98,148,101,87,70,98,103,112,154,103,79,79,84,120,100,126,133,89,65,84,133,145,163,135,124,94,100,128,114,177,159,132,82,115,197,169,149,147,121,86,115,173,187,156,182,145,93,132,151,152,139,167,152,105,117,177,156,150,190,131,124,161,201,198,206,201,167,117,157,187,193,218,188,156,128,179,201,213,203,205,182,138,143,213,180,203,168,152,141,122,195,193,170,197,167,110,123,204,177,176,169,167,100,157,204,185,164,191,148,112,123,186,148,133,143,107,107,100,175,212,164,170,141,102,134,148,173,169,196,154,108,113,193,199,163,142,129,94,78,87,92,80,65,43,67,65,91,114,70,56
2016,68,89,81,126,144,131,124,112,85,110,115,190,175,160,122,99,123,141,137,137,148,134,110,137,176,193,177,153,146,96,114,175,166,187,149,133,107,96,167,154,149,166,152,97,121,154,156,169,176,145,89,116,178,183,189,148,125,86,116,184,154,178,157,136,102,124,198,146,170,165,114,129,115,173,165,168,165,130,81,130,168,144,154,180,105,106,92,156,176,169,141,146,105,130,182,209,171,175,155,103,136,184,169,143,145,105,107,134,152,152,125,182,128,105,107,164,164,194,149,127,115,138,151,181,161,150,130,111,113,182,151,172,164,134,105,101,144,165,129,151,100,94,92,122,152,127,123,118,74,93,103,126