2008,0,0,0,0,0,0,0,0,0,0,0,0,0,0,0,0,0,0,0,0,0,0,0,0,0,0,0,0,0,0,0,0,0,0,0,0,0,0,0,0,0,0,0,0,0,0,0,0,0,0,0,0,0,0,0,0,0,0,0,0,0,0,0,0,0,0,0,0,0,0,0,0,0,0,0,0,0,0,0,0,0,0,0,0,0,0,0,0,0,0,0,0,0,0,0,0,0,0,0,0,0,0,0,0,0,0,0,0,0,0,0,0,0,0,0,0,0,1,0,0,0,0,0,0,0,0,0,0,0,0,0,0,1,0,0,0,0,0,0,0,0,0,0,0,0,0,0,0,0,0,0,0,0,0,0,0,0,0,0,0,0,0,0,0,0,0,0,0,0,0,0,0,0,0,0,0,0,0,0,0,0,1,0,0,0,0,0,0,0,0,0,0,0,0,0,0,0,0,0,0,0,0,0,0,0,0,0,0,0,0,0,0,0,0,0,0,0,0,0,0,0,0,0,0,0,0,0,0,0,0,0,0,0,0,0,0,0,0,0,0,0,0,0,0,0,0,0,0,0,0,0,0,0,0,0,0,0,0,0,0,0,0,0,0,0,0,0,0,0,0,0,0,0,0,0,0,0,0,0,0,0,0,0,0,0,0,0,0,0,0,0,0,0,0,0,0,0,0,0,0,0,0,0,0,1,0,0,0,0,0,0,0,0,0,0,0,0,0,0,0,0,0,0,0,0,0,0,0,0,0,0,0,1,0,0,0,0,0,0,0,0,0,0,0,0,0,0,0,0,0,0,0,0,0,0,0,0,0,0,0,0,0,0,0,0,0
2009,0,0,0,0,0,0,0,0,0,2,0,0,0,0,0,0,0,0,1,0,0,0,0,0,0,0,0,0,0,0,0,0,0,0,0,0,0,0,0,0,0,0,0,0,0,0,0,0,0,0,0,0,0,0,0,0,0,0,0,0,0,0,0,0,0,0,0,0,0,0,0,0,0,0,0,0,0,0,0,0,0,0,0,0,0,0,0,0,1,0,0,0,0,0,1,2,1,0,0,0,0,0,0,0,0,0,0,0,0,0,0,0,0,0,0,0,0,0,0,0,0,0,0,0,0,0,0,0,0,0,0,0,0,0,0,0,0,2,1,0,0,0,0,0,0,0,0,0,0,0,0,0,0,0,0,0,0,0,3,0,0,0,0,0,0,0,0,0,0,0,0,0,0,0,0,0,0,0,0,0,0,0,0,0,0,0,0,0,0,0,0,0,0,0,2,0,0,0,0,0,0,0,0,0,0,0,0,0,0,0,0,0,0,0,0,0,0,0,0,0,0,0,0,1,0,0,0,0,0,0,0,0,0,0,0,0,0,0,0,0,0,0,0,0,0,0,2,0,0,0,0,0,0,0,0,0,0,0,0,0,0,0,0,0,0,0,0,0,0,0,0,0,0,0,0,0,0,0,0,0,0,0,0,0,0,0,0,0,0,0,0,0,0,0,0,0,0,2,0,2,0,0,0,1,0,0,0,0,0,0,0,0,0,0,0,0,0,1,0,0,0,0,0,0,0,0,0,0,1,0,0,0,1,0,0,0,0,1,0,0,0,0,0,0,0,0,0,0,0,0,0,0,2,0,0,0,0,1,0,0,0,0,0,2,0
2010,1,0,0,0,0,0,0,1,0,0,0,1,0,0,0,0,0,0,1,1,2,1,1,1,0,1,1,0,3,6,0,0,3,1,0,0,0,0,1,1,1,0,2,0,0,0,0,0,0,1,0,0,0,0,0,0,0,0,1,1,0,0,0,0,0,0,0,0,0,0,0,0,0,0,0,0,0,0,0,0,0,0,0,0,1,0,1,0,0,0,0,0,0,0,1,0,0,0,1,0,0,0,1,0,0,0,0,0,0,1,1,1,0,0,0,0,0,0,0,0,0,1,0,0,0,0,0,0,0,0,1,0,0,0,0,0,0,0,0,0,0,0,0,0,0,0,0,0,0,0,0,0,0,0,0,0,0,0,0,0,0,0,0,0,0,1,0,0,0,0,0,0,0,0,0,0,0,0,0,0,0,0,0,0,0,0,0,0,0,0,0,0,0,0,0,0,0,0,0,0,0,0,0,0,0,0,0,0,0,0,1,0,0,0,0,0,0,0,0,0,0,0,0,0,0,0,0,0,0,0,0,0,0,0,0,0,0,0,0,0,0,0,0,0,0,0,0,0,0,0,0,0,0,0,0,0,0,0,0,0,0,0,0,0,1,0,0,0,0,0,0,0,0,0,2,0,0,0,0,0,0,0,0,0,0,0,3,0,0,1,0,0,0,0,0,0,0,0,0,0,0,0,0,0,0,0,0,0,0,0,0,0,0,0,0,0,0,0,0,0,0,0,0,0,1,0,0,0,0,0,0,0,0,0,0,0,0,0,0,0,2,0,0,1,0,0,0,0,0,0,0,0,0,0,0,1,0,0,0,0,0,0,0,0,0
2011,0,0,0,0,0,0,0,0,0,0,0,0,0,0,0,0,0,0,0,0,0,0,0,0,0,0,0,0,0,0,0,0,0,0,0,0,0,0,0,0,0,0,0,0,0,0,0,0,0,0,0,0,0,0,0,0,0,0,0,0,0,0,0,0,0,36,29,23,39,239,132,105,127,107,76,56,38,36,28,29,30,21,36,49,12,16,13,7,12,11,15,9,11,13,16,10,29,21,13,9,24,17,36,15,5,13,12,13,15,15,18,14,7,12,9,18,11,16,9,8,8,13,11,8,11,7,11,5,7,9,11,29,24,7,8,8,12,14,19,21,21,16,11,12,18,18,14,6,7,12,10,11,13,10,11,10,9,10,12,7,10,5,10,12,14,14,13,31,8,8,12,13,19,14,10,11,14,17,11,11,10,13,13,5,14,6,6,6,8,10,10,7,12,7,8,8,7,8,3,12,7,9,6,9,9,13,19,17,8,6,7,8,10,9,8,11,8,5,6,8,12,10,8,8,9,5,5,5,6,15,8,8,6,4,106,188,28,21,5,18,10,3,4,12,7,13,14,4,10,20,10,6,22,10,6,6,9,7,12,9,10,25,12,8,20,22,8,7,7,8,8,15,7,10,13,20,7,6,5,11,8,9,4,8,11,11,11,15,12,6,9,5,13,34,4,10,15,13,9,16,17,20,10,11,11,18,13,5,14,134,51,19,19,19,16,13,15,17,9,7,3,8,3,6,11,13,10,11,4,5,8,13,7,8,5,6,6,5,7,6,7,10,21,5,6,10,4,12,5,10,7,8,7,4,3,5,0,0,0,3,6,6,9,9,11
2012,15,13,10,8,16,8,5,9,9,7,9,9,8,4,6,11,4,3,3,7,5,7,10,4,5,2,8,7,11,6,12,4,5,6,6,10,9,7,10,16,5,11,3,13,9,13,12,6,8,9,9,14,7,8,9,7,7,11,6,9,5,10,13,5,13,15,8,5,7,5,7,6,9,7,7,11,6,2,10,7,12,6,2,5,9,10,9,10,14,6,4,8,8,18,8,12,5,12,7,7,13,32,52,14,11,7,6,5,13,15,14,8,14,11,11,13,12,13,5,13,14,8,11,4,10,5,9,10,5,9,6,5,14,8,12,9,12,9,11,6,11,8,12,9,8,6,11,7,12,14,15,9,13,10,12,14,10,13,3,9,16,6,8,9,6,5,7,4,2,7,11,10,14,6,4,4,17,6,7,11,6,12,5,4,7,10,8,3,6,14,7,7,9,6,9,5,5,5,8,5,2,8,4,5,8,15,7,4,6,4,3,1,7,7,6,8,4,6,3,10,13,16,3,6,5,7,7,5,3,3,5,4,10,11,11,4,11,3,5,14,6,8,7,7,12,5,5,7,4,5,7,13,9,8,7,7,13,7,5,3,3,6,8,5,7,6,2,9,7,10,7,8,9,9,7,7,7,6,4,4,6,10,3,6,6,2,8,16,8,6,13,9,7,8,5,9,9,5,2,5,6,6,14,3,6,7,8,5,4,10,9,8,7,17,10,12,9,11,10,9,6,7,9,6,6,7,8,4,4,10,7,6,10,10,3,5,7,2,8,8,7,14,6,5,6,9,9,8,7,3,8,10,11,7,3,5,15,3,2,4,2,6,8,8,3,8
2013,4,6,8,8,8,4,16,12,9,9,6,6,4,5,2,6,6,4,5,6,8,3,3,7,10,5,5,2,6,10,5,7,2,7,3,4,6,4,5,3,4,5,4,6,3,5,8,9,4,3,4,5,4,4,8,7,5,6,6,3,5,3,6,6,4,9,7,8,5,8,12,18,15,7,6,5,8,9,8,8,7,3,4,8,10,6,7,13,7,15,13,13,8,4,6,6,7,6,16,8,9,11,9,4,4,15,14,12,7,16,10,13,5,11,6,11,6,8,3,14,5,7,9,16,9,8,4,5,14,6,15,12,7,20,10,7,8,7,6,11,7,6,13,16,12,11,9,7,15,12,6,10,9,9,13,11,9,12,13,11,8,9,9,22,20,11,6,11,6,8,7,9,13,7,6,11,8,7,8,8,9,7,14,10,2,9,6,7,11,10,6,10,10,13,12,7,10,16,5,11,13,9,7,9,3,7,6,6,7,13,19,23,6,6,6,8,12,9,12,12,7,14,4,4,7,7,9,7,9,6,8,12,9,4,11,15,10,5,13,9,8,5,8,5,9,11,8,8,5,4,8,10,10,4,9,9,5,4,6,6,5,4,6,7,6,11,7,7,5,7,10,6,7,8,6,6,5,1,9,7,6,8,10,7,12,6,4,10,18,4,8,7,6,10,9,6,10,6,9,9,4,6,5,8,6,4,7,3,7,8,6,10,4,5,17,8,10,7,12,5,5,7,5,4,8,4,1,3,3,4,7,4,2,5,7,9,8,6,12,4,3,7,4,9,6,6,5,4,6,4,3,5,7,6,5,9,7,5,9,6,6,5,8,8,6
2014,7,2,8,4,4,4,4,8,6,7,7,5,8,9,10,13,11,14,8,9,10,1,17,8,7,9,8,6,6,10,11,4,4,6,19,5,9,9,4,2,6,8,5,7,10,8,11,10,11,9,9,8,9,6,7,14,13,9,11,8,8,11,9,10,7,6,4,5,7,5,9,9,9,6,11,13,11,6,11,11,9,12,6,8,10,8,4,9,7,10,12,15,22,9,9,5,5,7,3,5,7,7,4,8,9,8,4,9,7,8,16,9,8,4,8,7,4,10,9,4,5,11,5,4,10,10,9,10,12,8,8,10,5,6,7,4,7,8,10,8,8,8,4,10,5,10,17,14,6,30,11,7,5,11,15,7,9,6,10,9,6,11,10,8,6,4,8,5,7,9,8,10,5,8,13,11,9,5,5,8,9,5,5,6,4,7,7,16,5,7,7,7,4,6,5,3,3,9,5,3,7,6,9,9,22,5,3,3,7,8,5,1,3,3,4,6,6,12,13,6,2,6,8,12,99,385,111,73,52,78,40,26,37,35,24,32,25,34,13,14,22,12,16,12,7,12,19,12,10,18,13,14,6,9,9,10,9,6,9,10,11,13,6,9,8,11,7,12,10,8,7,9,6,12,6,7,8,6,9,6,11,6,10,4,6,24,13,14,2,7,8,8,14,4,9,9,11,10,10,10,11,14,9,12,9,6,9,8,8,9,7,6,13,11,11,12,8,13,14,11,10,11,10,10,11,12,10,14,6,9,4,9,13,6,12,10,7,14,4,5,6,10,9,11,17,8,3,8,11,9,5,11,12,5,8,9,13,6,9,12,9,6,4,6,10
2015,7,8,4,5,11,0,5,8,5,8,7,5,3,6,7,8,6,4,7,5,7,6,7,4,7,7,11,6,11,8,7,5,7,9,11,7,10,8,7,7,6,7,8,6,12,5,14,8,9,9,5,10,7,5,9,13,6,8,8,6,15,7,7,11,9,1,10,11,4,6,3,4,12,8,8,9,11,7,6,9,4,5,7,6,9,9,2,3,6,7,7,10,4,10,11,7,10,4,4,6,4,8,4,12,8,10,13,6,8,8,12,6,7,9,10,20,28,17,8,12,9,10,9,7,9,10,16,11,0,8,7,21,12,6,8,7,10,7,9,7,10,8,6,6,0,0,8,8,6,6,8,9,5,8,14,8,11,5,11,7,9,8,1,3,4,7,7,2,5,13,8,4,7,3,7,7,10,6,6,4,3,25,8,1,4,5,7,6,3,8,3,4,3,3,9,7,13,8,3,4,10,6,3,5,17,6,8,8,8,6,4,6,7,7,3,7,6,7,8,9,16,8,5,2,3,4,5,11,9,6,12,9,4,11,3,5,4,11,2,8,2,4,10,9,4,10,13,3,15,7,11,4,11,8,7,2,5,10,8,20,17,4,10,6,9,5,4,11,4,8,5,5,8,5,4,9,8,11,7,8,14,5,6,7,5,3,17,6,11,6,4,3,12,1,14,7,6,5,8,12,7,9,8,5,6,13,9,15,6,10,8,11,10,2,2,7,9,5,9,15,4,6,5,7,9,5,5,6,5,4,5,4,4,3,4,3,0,1,0,2,2,3,5,8,8,4,3,1,4,6,2,5,5,4,4,9,5,4,2,5,0,1,1,8,1
2016,3,2,2,2,7,6,6,7,3,2,3,2,6,4,6,4,1,2,2,5,0,3,3,6,4,6,0,4,7,3,3,1,5,1,3,3,6,2,3,6,4,2,2,2,5,2,3,4,9,6,6,2,3,6,3,4,2,2,1,4,7,9,7,6,3,0,1,5,2,4,3,3,4,2,1,5,5,4,5,11,3,3,4,4,3,1,4,1,7,7,6,1,4,3,3,3,4,4,1,3,1,6,7,2,4,13,3,8,2,9,8,4,8,4,1,4,4,7,4,3,0,3,2,4,2,5,7,3,2,3,5,1,1,3,3,2,4,3,2,5,5,6,2,3,4,2,2,3,1,0,2,0