2008,171,242,292,272,249,269,390,483,524,459,366,254,408,476,581,552,578,452,231,342,474,562,537,556,379,261,323,561,527,436,477,417,236,317,473,580,494,548,387,221,323,534,510,552,502,364,158,198,451,490,514,470,422,204,331,520,521,465,458,404,290,292,461,465,474,400,364,184,289,424,455,479,460,351,239,249,440,402,384,325,254,202,201,410,431,374,414,343,206,273,414,441,448,380,360,193,234,417,361,435,387,338,188,261,464,431,474,452,373,268,294,435,377,424,405,302,243,334,456,433,417,442,331,225,246,412,384,437,456,302,231,270,344,341,360,376,330,212,253,386,403,406,355,304,210,218,357,376,482,467,331,189,271,361,426,400,358,303,201,231,379,362,315,359,232,177,235,383,426,368,332,246,163,184,250,275,268,270,204,179,209,237,296,217,290,181,278,252,265,293,351,251,213,161,190,235,261,257,286,203,137,216,297,277,301,261,190,140,224,267,256,295,251,214,131,171,238,265,241,254,195,195,246,302,301,256,281,185,165,276,338,387,292,344,282,223,264,440,378,470,392,354,258,353,411,594,579,600,542,296,460,597,768,800,905,596,287,579,945,862,813,879,684,329,572,805,957,950,858,690,420,655,854,862,916,884,735,353,601,956,879,943,827,685,374,596,995,1067,850,951,798,379,622,923,966,1006,833,707,370,595,860,959,881,813,658,358,514,883,807,774,728,631,393,476,806,808,977,806,753,370,589,871,671,671,732,530,381,564,685,656,453,338,260,266,416,619,600,689,639,541,324,427,587,622,640,576,457,313,410,573,577,533,601,379,233,202,282,194,169,116,175,133,136,222,280,197
2009,148,231,272,334,466,506,502,554,432,385,500,574,579,683,709,522,332,366,572,636,677,614,510,315,398,575,636,598,634,473,280,395,580,574,645,666,516,309,384,637,643,596,615,498,245,326,562,638,644,602,605,277,395,636,645,623,665,591,326,418,541,486,651,549,525,267,425,571,575,507,508,459,243,389,517,536,501,531,396,235,326,493,516,510,522,434,267,311,488,462,498,491,388,270,277,440,469,452,435,313,260,279,415,461,460,548,404,233,355,417,481,477,494,412,300,297,452,444,435,439,403,243,318,482,476,473,493,368,259,313,517,521,518,445,415,234,391,482,505,499,478,349,251,301,374,503,466,431,354,239,338,487,526,456,470,422,249,347,437,458,431,408,305,214,312,395,428,438,420,272,230,269,321,333,315,260,250,195,221,434,406,332,279,196,170,189,260,372,260,321,243,223,227,320,321,354,362,271,204,243,356,424,349,321,273,187,291,319,389,365,440,260,204,227,295,263,292,284,275,241,244,345,357,286,308,269,214,240,373,412,488,373,367,294,382,622,433,605,472,385,286,433,526,663,842,800,500,369,425,661,860,916,933,749,503,714,1073,1127,1101,987,798,443,668,983,503,714,1073,1127,1101,987,798,443,668,886,886,420,706,944,1182,1214,1077,825,423,662,937,1047,954,1047,792,410,482,889,863,917,956,818,426,618,986,1109,1043,936,671,354,485,842,1009,1009,988,784,437,579,984,1020,871,904,866,353,596,982,783,813,795,636,374,473,599,685,550,413,342,362,440,658,676,891,632,635,324,440,642,657,687,701,626,382,543,665,675,872,666,543,267,361,325,280,264,171,147,170,175,234,285,335,236
2010,240,260,264,426,432,537,535,445,332,435,633,701,753,748,610,469,413,595,764,706,764,595,543,543,636,691,781,705,602,371,415,740,715,796,678,676,433,535,701,766,714,629,582,306,360,520,590,642,663,518,376,450,677,664,710,558,466,345,381,578,692,640,686,541,350,513,635,650,569,595,532,291,387,544,508,529,578,477,312,362,557,492,552,557,477,314,388,485,478,539,428,373,281,309,463,579,576,496,449,291,370,536,552,582,499,464,360,370,554,617,542,633,530,336,409,597,551,579,531,449,298,373,581,568,530,539,470,332,328,451,585,479,392,395,330,339,472,368,412,465,416,297,359,463,465,461,404,335,246,283,345,431,467,502,361,312,362,472,442,397,376,429,436,453,382,324,320,346,302,261,289,358,371,357,326,228,215,220,266,324,326,269,255,257,378,400,305,295,305,295,215,236,250,255,255,273,250,169,225,265,316,299,330,306,270,374,445,466,428,340,346,298,294,381,410,423,358,410,293,307,386,511,376,412,347,268,317,430,387,449,427,358,258,369,432,534,519,527,451,297,372,623,707,700,657,591,437,554,738,1020,1093,946,802,426,722,1028,1080,1098,1058,777,475,614,1002,1093,1080,1049,850,525,831,1155,1085,1114,1128,919,431,765,1142,1276,1203,1082,921,471,673,1072,1096,1203,1127,929,495,797,1176,1219,1330,1025,970,520,733,1334,1163,1201,1060,797,488,595,920,1128,1203,1008,968,449,685,1050,1123,1056,975,782,496,633,817,920,1010,954,775,404,667,929,816,656,485,626,391,555,904,942,968,956,781,402,629,1046,876,908,815,712,411,691,932,846,907,754,480,290,382,476,392,373,282,187,186,205,273,293,263,311,288
2011,306,385,517,583,770,705,652,513,559,840,810,883,975,652,504,600,839,959,912,904,755,471,665,862,876,836,911,663,373,486,803,735,762,768,673,500,523,822,860,815,828,689,404,596,777,827,970,830,570,351,461,632,797,776,795,652,420,585,852,774,809,763,624,431,536,769,793,768,801,609,407,497,754,749,722,626,509,334,435,633,705,571,604,480,331,418,656,683,578,619,509,303,508,606,611,639,628,611,341,391,710,602,660,656,548,390,398,594,575,569,507,412,335,345,568,691,753,601,539,379,467,601,672,643,605,534,369,413,642,638,599,593,460,347,425,571,572,586,603,476,343,435,585,618,605,584,454,293,364,403,489,516,519,454,347,464,518,520,572,515,445,355,414,496,527,535,441,317,286,325,489,486,496,419,348,232,295,469,419,374,475,286,254,290,364,394,545,447,323,275,414,433,493,383,389,301,222,273,363,399,396,387,341,273,338,417,431,378,373,327,267,288,395,443,445,434,372,281,359,504,462,452,389,334,265,268,288,412,366,461,389,334,482,481,524,580,544,479,324,413,535,661,681,754,656,376,497,576,751,1011,950,733,510,729,957,1166,1105,1019,804,555,830,1001,1001,1099,1123,920,543,748,1075,1227,894,955,885,528,796,1208,1196,1231,1144,1005,646,717,960,1106,1220,1298,971,515,731,1191,1287,1281,1206,972,465,753,1199,1193,1182,1259,927,505,730,1170,1110,1361,1162,998,506,785,1137,1203,1291,1126,776,455,676,1177,1274,1180,1087,926,522,717,994,1014,715,535,537,472,679,988,1022,1188,1136,969,598,739,1045,1114,968,1024,845,539,729,1026,1015,978,910,716,352,541,981,717,536,430,432,432,432,401,332,349,385,371,303
2012,244,484,705,693,673,626,455,594,739,868,870,845,700,464,505,670,938,950,851,709,468,575,839,881,859,872,718,426,631,783,839,902,812,727,405,596,915,916,858,866,713,417,585,858,839,854,901,639,440,536,682,861,858,800,664,452,505,788,890,808,895,705,398,570,841,770,775,733,600,434,483,633,664,658,705,509,387,479,626,625,601,506,459,313,412,584,630,583,562,419,365,387,546,624,530,543,375,297,360,556,568,587,553,515,357,534,614,701,657,652,510,351,547,698,680,663,636,481,369,479,653,677,750,645,571,400,545,714,683,649,661,521,391,441,680,666,559,575,453,362,467,595,551,604,560,516,325,359,483,601,590,540,428,312,369,587,681,582,511,486,346,433,548,626,577,508,419,372,408,521,627,636,465,366,325,334,466,533,552,416,351,294,377,462,508,420,506,362,296,377,489,436,427,417,355,264,304,367,447,464,405,381,306,344,397,499,638,496,409,300,588,463,452,400,435,403,311,409,439,439,389,493,436,278,391,522,470,535,454,405,332,347,517,597,634,666,576,414,471,652,650,753,884,693,521,682,857,1061,1098,1065,914,546,878,1417,1443,1360,1230,1018,633,941,1236,1357,1356,1330,1103,568,987,1337,1408,1289,1161,974,601,947,1388,1590,1459,1318,1140,643,949,1392,1378,1257,1426,989,559,924,1355,1411,1377,1342,1024,513,889,1265,1335,1261,1134,889,548,779,1165,1091,1069,1029,1045,632,957,1369,1266,1261,1271,949,585,693,994,1320,1239,1120,971,488,677,1030,1018,922,580,510,543,576,1092,1199,1236,1044,946,571,745,1115,1098,1182,995,885,560,785,1190,1106,1068,929,797,472,640,877,870,821,744,461,324,283,212,260,309,305,295,307,293,294
2013,309,472,577,522,390,483,758,857,865,889,763,470,705,945,1018,989,959,784,508,625,763,954,1012,1010,813,481,684,895,945,975,956,773,480,717,1112,1045,1171,1004,791,508,638,1027,1091,1142,919,784,480,640,925,1056,1017,934,798,496,660,925,978,948,868,744,512,703,830,905,956,918,753,543,659,819,881,837,824,802,456,547,850,870,770,766,701,471,529,744,699,646,590,456,371,412,660,1807,1214,691,645,422,489,803,767,720,718,630,389,646,768,831,894,795,694,482,569,816,838,871,750,624,448,564,786,696,780,696,678,533,609,915,814,750,724,613,509,544,734,698,732,732,621,439,610,655,687,754,673,517,454,447,566,618,725,651,570,406,447,696,679,640,581,534,356,462,562,648,581,628,500,366,395,532,671,636,614,417,410,411,573,496,596,556,363,289,325,425,503,436,370,333,257,370,433,459,506,389,401,345,315,320,482,429,518,358,310,426,481,353,128,404,294,273,304,443,397,409,437,358,294,389,379,429,479,351,362,279,339,382,626,501,420,388,321,389,398,408,431,426,338,318,389,489,506,569,506,446,345,478,571,737,738,741,545,402,517,770,832,798,837,724,490,698,908,862,890,892,672,478,690,872,1018,1046,858,761,485,727,909,1039,1040,1127,827,499,751,1086,1210,1115,1026,786,437,690,1014,1047,1023,1042,906,512,663,1028,1019,976,979,814,523,643,969,977,969,933,661,434,583,878,1023,1052,865,709,411,609,1070,1181,1147,1214,1070,698,897,1030,1242,973,961,742,433,535,896,767,636,566,380,365,569,720,844,949,1000,729,608,699,987,1062,1174,781,565,351,504,748,622,593,490,358,169,241,250,202,170,218,214,189,193,252,228
2014,224,265,322,289,289,289,626,627,581,556,380,476,676,633,694,606,543,309,491,570,682,741,719,544,409,460,677,687,580,576,517,365,452,568,627,619,626,570,408,530,659,688,722,645,496,341,409,603,631,630,740,537,308,449,623,664,666,611,535,374,480,633,625,685,616,516,320,400,563,561,598,558,520,362,396,540,569,548,560,447,310,387,597,602,568,502,436,336,430,644,631,567,721,695,359,375,563,611,571,506,483,353,385,520,588,568,508,449,345,383,696,679,613,608,510,387,428,620,574,532,515,536,349,408,605,585,566,473,508,403,412,515,514,529,436,406,279,370,476,554,449,508,387,325,382,419,481,504,461,362,276,354,448,482,459,472,389,301,372,420,475,429,415,347,277,320,423,463,413,408,329,347,304,376,437,447,468,355,246,344,435,405,387,369,268,276,336,354,377,338,336,342,270,285,387,360,352,342,304,222,306,393,380,395,376,307,244,300,320,379,318,389,262,252,288,299,377,354,361,331,322,408,761,613,617,552,364,321,502,688,624,507,517,397,333,390,536,780,566,627,459,332,490,675,781,902,714,568,400,593,753,811,865,827,654,485,611,861,900,820,805,651,429,593,916,886,887,859,672,451,720,906,906,906,830,710,458,591,889,970,975,993,770,533,692,845,939,910,872,683,365,602,840,864,789,739,736,448,619,963,886,844,842,576,374,531,879,933,866,788,659,406,540,698,729,746,695,642,404,495,782,741,726,693,620,420,445,739,608,533,445,398,371,350,702,847,815,653,602,394,469,719,797,732,700,607,369,503,677,667,692,509,347,261,256,286,254,247,182,247,234,237,283,278,279
2015,229,265,286,298,494,500,461,499,408,304,410,511,493,548,521,467,280,357,506,596,556,635,489,308,399,686,623,587,593,517,354,463,558,646,653,646,528,359,422,673,667,600,543,468,287,386,495,568,551,508,509,321,458,639,563,596,525,499,350,414,565,591,600,542,430,329,403,479,563,481,543,488,309,384,544,490,548,439,412,281,371,465,469,510,479,398,282,347,503,593,509,468,426,330,324,504,496,592,545,445,292,398,485,578,542,503,458,344,376,599,629,705,695,435,316,469,658,619,544,555,513,361,460,651,560,762,539,453,0,398,535,489,542,497,422,374,401,506,459,469,466,334,257,418,0,0,438,466,409,372,324,463,467,521,521,426,344,345,431,457,435,421,296,232,303,361,336,346,320,256,210,205,320,295,311,296,265,139,214,270,328,287,306,262,172,221,263,409,339,573,295,215,198,290,332,271,274,288,201,259,311,310,302,290,240,209,230,259,321,290,280,256,193,280,227,244,281,311,275,168,242,436,485,392,430,273,278,362,583,572,414,338,319,315,333,495,443,417,432,326,223,303,434,568,580,514,367,346,395,492,595,606,624,478,345,426,598,624,610,649,574,320,420,615,652,688,592,519,316,456,645,724,662,646,552,370,447,694,735,703,604,535,356,430,666,734,694,694,572,394,558,791,728,644,670,574,357,460,690,629,622,569,490,293,400,612,666,605,587,510,339,427,560,638,473,602,480,346,410,611,581,520,538,485,306,384,537,542,418,339,248,297,331,548,604,574,593,423,299,395,490,569,835,584,451,320,401,562,534,476,465,266,177,202,240,211,183,166,141,119,159,206,176,205,142
2016,167,219,225,352,360,396,405,290,265,348,426,384,406,369,348,244,318,371,436,495,452,426,262,284,459,450,470,434,365,237,331,453,497,621,474,409,270,337,462,502,544,451,386,252,320,420,480,503,425,400,247,313,475,507,442,476,484,272,366,479,463,470,431,423,264,347,434,383,441,394,316,214,236,328,360,359,396,285,190,250,326,311,367,298,210,204,202,350,365,351,391,309,192,275,354,350,409,352,343,220,277,364,377,374,339,313,227,264,388,420,369,411,304,250,288,378,348,372,381,320,198,246,356,381,344,339,319,205,764,518,435,393,382,282,282,270,306,333,311,380,343,231,251,376,385,332,325,298,211,230,325,361