2008,0,0,0,0,0,0,0,0,0,0,0,0,0,0,0,0,0,0,0,0,0,0,0,0,0,0,0,0,0,0,0,0,0,0,0,0,0,0,0,0,0,0,0,0,0,0,0,0,0,0,0,0,0,0,0,0,0,0,0,0,0,0,0,0,0,0,0,0,0,1,0,3,0,0,0,0,0,1,0,1,0,0,0,0,1,1,0,0,0,2,0,1,0,0,0,0,0,0,0,0,0,0,0,1,0,0,0,1,0,2,0,0,0,3,0,0,0,0,0,0,0,1,0,0,0,1,0,0,1,0,0,1,1,0,0,0,0,0,0,0,0,0,0,1,0,0,0,0,0,0,0,0,0,0,0,0,0,0,3,0,0,0,0,1,0,0,0,0,0,0,0,0,0,0,1,0,0,0,0,0,0,0,0,0,0,0,0,0,0,1,0,0,0,0,0,0,0,0,0,0,0,0,0,0,0,0,0,0,0,0,0,1,0,0,0,0,0,0,0,0,0,0,0,0,0,0,0,0,0,0,0,0,1,0,0,0,0,0,0,0,0,0,0,0,0,0,0,0,0,0,0,0,0,0,0,0,0,1,0,0,0,0,0,1,0,0,1,0,0,0,0,0,0,0,0,0,0,0,0,0,0,0,0,0,0,0,0,1,0,0,0,1,0,0,0,2,0,0,0,0,0,2,0,0,0,0,0,0,0,0,0,0,0,0,0,0,0,0,0,0,0,0,0,0,0,0,0,0,0,3,0,1,0,0,0,0,1,1,0,0,0,5,24,20,11,16,7,12,14,16,29,25,20,9,11,11,13,14,16,9,14,10,13,12,13,10
2009,7,3,16,5,7,14,16,10,15,14,24,14,24,23,10,8,14,12,21,8,13,21,14,11,11,7,25,17,13,32,6,13,23,11,12,16,31,16,22,20,16,33,15,20,5,10,17,25,20,11,12,14,13,22,21,16,18,20,10,16,33,14,14,25,30,17,20,16,21,15,21,18,6,12,21,26,31,18,18,18,12,13,14,23,21,14,3,20,22,19,11,13,20,16,20,22,14,17,16,7,11,15,20,17,15,18,24,16,8,19,9,17,15,18,12,16,9,15,15,7,19,7,9,32,8,18,21,14,9,12,18,19,27,27,17,18,14,20,12,17,22,16,9,12,16,20,22,21,16,12,9,18,19,16,15,9,8,11,14,16,20,14,9,10,10,21,11,20,28,20,13,6,24,14,11,9,17,12,11,18,13,19,10,12,7,11,20,22,22,14,22,12,10,16,11,11,21,14,12,8,20,7,13,19,8,11,16,17,31,21,20,9,9,9,24,12,17,17,15,12,6,15,12,18,10,7,18,18,17,14,18,14,11,4,19,8,23,23,30,14,12,7,14,16,11,7,28,6,13,16,15,8,18,8,12,14,11,24,21,21,18,8,14,21,12,14,11,24,21,21,18,8,14,37,20,23,12,11,10,17,28,16,10,13,23,14,15,14,7,17,12,19,13,20,21,19,12,28,25,31,14,14,18,18,11,22,31,32,24,21,12,18,20,21,19,28,19,20,17,38,27,45,28,16,19,13,15,22,18,15,15,14,10,13,16,15,26,19,11,14,17,18,28,16,8,10,17,18,20,14,25,25,18,14,11,18,13,7,8,11,7,11,21,12,15
2010,15,10,9,24,15,23,15,23,9,17,25,21,22,21,14,15,12,21,15,16,16,17,16,16,18,25,15,26,18,15,16,18,22,26,28,17,20,11,19,21,29,29,23,16,26,27,18,18,26,31,18,17,27,24,19,17,13,21,11,17,37,16,17,21,14,16,30,30,30,28,25,12,21,22,22,40,13,26,13,10,26,24,28,15,20,15,23,30,19,23,32,25,12,10,14,20,19,23,22,23,21,27,31,25,33,22,22,24,35,15,18,23,20,18,18,22,31,27,29,23,16,18,32,24,29,38,36,21,17,33,29,23,30,29,18,16,21,18,27,29,26,13,19,42,33,24,28,15,15,13,17,25,28,15,15,13,24,33,27,28,18,21,35,27,27,14,25,24,17,36,31,19,50,37,27,17,13,10,12,20,15,12,12,10,13,14,14,12,14,12,13,6,12,17,23,18,15,11,17,13,11,18,13,29,16,17,31,18,33,13,27,14,9,18,15,19,23,14,13,22,20,28,15,15,15,17,14,24,15,16,18,29,16,16,26,28,19,14,16,16,17,21,15,15,26,18,14,15,28,8,20,30,13,19,20,22,14,21,27,33,14,24,22,19,21,42,27,22,28,16,22,13,21,8,15,9,38,25,24,19,30,9,10,23,26,26,28,19,14,19,18,22,51,30,24,18,19,23,26,20,19,18,19,18,17,37,20,28,31,24,29,34,37,14,25,32,19,18,35,44,31,25,23,20,23,17,27,27,11,30,13,17,23,19,22,25,12,18,21,34,43,27,24,19,19,26,36,20,32,23,27,13,12,15,23,17,14,16,9,8,13,13,9,10,11
2011,6,18,8,21,21,17,15,12,13,22,25,12,20,16,11,25,22,29,23,16,19,11,6,26,20,15,21,23,17,21,21,15,22,26,18,18,19,46,37,24,15,24,16,15,20,26,29,24,32,10,23,30,14,20,17,25,18,18,18,19,31,21,27,25,27,23,16,29,31,17,19,12,22,12,14,35,14,6,15,13,19,26,33,16,11,19,33,31,16,26,35,30,30,20,36,26,17,14,9,16,26,22,31,20,24,20,16,27,34,24,35,21,19,14,26,27,15,20,17,20,16,31,25,14,17,34,23,20,21,15,21,28,25,24,24,23,23,13,20,28,8,15,19,17,30,28,22,15,17,22,10,15,14,17,15,9,20,19,16,22,16,13,17,19,16,29,19,19,10,18,24,24,34,19,26,9,14,20,25,27,22,21,13,20,24,23,29,22,16,7,30,26,36,20,15,13,17,10,15,23,25,32,30,12,8,19,11,26,21,23,18,20,23,68,24,24,22,20,26,18,27,76,55,13,10,19,15,22,27,25,12,18,20,12,35,82,30,19,27,15,18,20,16,21,35,24,10,12,29,20,22,19,15,13,24,18,13,18,24,25,12,31,17,14,11,12,18,25,20,15,34,20,26,14,15,33,19,31,53,27,22,34,1033,695,281,145,74,36,41,71,52,47,52,42,37,30,36,45,46,41,31,22,95,54,38,29,39,35,21,34,46,32,38,38,37,37,26,24,46,41,29,33,24,21,32,35,47,36,28,30,28,40,50,31,49,37,14,28,50,51,33,55,54,34,43,58,31,27,38,21,28,30,29,19,22,39,24,24,24,20,18,39,41,22,35
2012,24,18,30,45,33,43,21,16,18,30,34,34,14,19,30,28,39,33,24,26,12,19,24,21,27,16,33,22,14,32,21,35,26,20,22,16,22,16,29,22,38,19,21,30,22,25,37,26,31,26,34,31,23,29,32,12,16,19,27,29,38,22,23,29,32,18,30,42,34,19,18,26,41,24,31,29,15,16,27,22,46,22,22,25,15,29,37,30,40,19,17,16,24,29,23,29,14,19,21,30,36,30,34,32,21,17,32,34,28,26,23,17,32,23,34,39,28,28,24,18,30,26,38,24,23,28,38,48,25,39,34,27,26,12,44,21,35,38,32,27,20,39,32,27,25,24,14,14,21,21,33,33,20,10,20,35,28,29,36,27,29,22,26,29,30,25,25,18,24,37,34,36,17,32,12,19,19,23,41,18,22,17,14,20,29,22,13,22,16,17,16,26,18,11,29,20,22,21,33,21,21,23,10,12,32,25,16,17,30,20,16,20,23,20,16,19,7,14,21,22,20,14,20,18,23,18,18,19,24,19,14,14,34,29,27,23,13,16,22,19,26,24,17,15,15,17,38,27,29,29,35,27,22,25,32,30,38,18,40,18,41,32,34,38,27,26,26,32,30,29,24,31,33,25,35,35,23,32,27,26,23,41,39,48,118,24,28,18,53,35,31,33,15,16,23,28,38,26,32,33,20,21,34,28,25,108,25,29,27,41,24,33,26,26,18,20,35,30,35,23,32,14,17,25,42,22,20,28,15,20,30,23,33,29,44,25,27,24,37,38,32,17,26,33,39,46,30,22,31,17,19,38,43,33,28,14,24,22,21,11,13,31,33,20,21,19
2013,17,37,36,34,30,72,47,30,36,33,31,21,23,23,41,41,36,33,17,16,36,35,26,20,37,29,16,39,27,32,25,16,26,22,29,28,31,39,40,16,17,21,33,44,40,19,19,25,32,38,25,37,23,18,20,39,39,43,46,36,21,24,37,30,35,49,32,12,28,30,47,40,25,28,17,26,44,64,30,39,24,19,32,31,25,29,30,27,11,23,28,41,25,37,17,18,39,34,31,36,45,34,26,30,27,35,44,42,27,29,26,34,35,44,38,25,33,31,37,41,35,28,79,26,21,32,23,41,41,32,26,27,45,41,34,24,22,22,20,35,45,23,29,35,40,15,35,20,26,23,29,10,22,31,23,25,23,19,30,18,35,32,23,38,25,20,23,26,19,46,33,20,13,16,17,22,17,23,33,28,17,13,29,31,29,26,11,16,27,26,23,22,24,13,12,41,18,24,36,17,18,19,36,27,7,28,18,21,20,20,16,16,17,20,10,19,11,15,19,27,23,27,11,28,25,16,17,11,10,28,13,32,16,11,16,13,21,22,18,14,14,16,8,8,19,12,14,16,11,11,12,14,20,15,18,18,16,18,28,25,18,16,18,21,22,25,30,19,28,25,8,13,13,33,15,18,20,12,11,14,20,18,23,19,19,12,28,31,25,34,22,24,15,16,20,26,27,13,18,14,22,21,32,28,22,19,14,35,23,26,26,9,5,20,19,38,18,15,28,20,15,27,36,21,29,24,19,26,19,22,35,24,18,19,27,30,15,25,27,20,18,17,24,32,28,33,19,8,104,38,29,24,20,19,7,15,19,11,17,13,19,12,8,21,20
2014,10,14,12,11,11,11,26,23,20,22,21,20,27,28,15,20,15,13,41,19,27,24,14,24,19,19,19,22,17,22,27,19,18,13,25,25,27,25,19,17,28,24,31,16,20,11,13,18,25,18,22,19,20,21,26,28,19,23,14,17,13,22,26,22,21,11,16,8,30,18,19,25,18,16,29,32,19,31,17,21,20,11,15,19,31,42,25,15,20,17,26,26,16,16,15,20,21,34,24,29,22,11,16,26,28,23,20,22,21,25,15,19,28,19,24,13,43,36,22,15,31,28,9,25,45,61,45,34,31,26,25,25,24,33,25,24,21,23,16,30,29,29,21,19,24,23,25,21,12,24,16,14,38,27,19,25,19,22,7,26,28,21,21,18,16,18,13,28,24,17,20,15,13,12,21,24,17,11,14,12,16,13,22,23,10,9,8,14,26,15,19,21,5,11,20,16,17,21,12,20,13,28,10,13,21,10,13,14,22,23,18,15,17,10,14,19,13,15,14,17,4,11,18,20,9,15,16,10,20,17,13,18,20,19,19,14,19,25,31,22,27,14,11,32,26,27,23,20,15,11,57,39,24,28,20,25,19,22,16,25,23,13,11,17,26,14,26,19,20,15,32,24,18,21,15,10,9,5,25,24,20,19,16,22,23,38,37,20,29,23,11,20,29,22,20,19,17,18,16,26,25,35,21,20,38,19,32,20,23,28,15,25,19,34,24,22,19,26,30,34,29,31,27,32,21,16,23,29,14,26,21,14,17,19,34,31,26,26,16,14,15,19,36,23,41,43,17,23,31,23,35,32,16,15,16,27,24,16,14,18,14,11,27,16,8
2015,18,19,16,44,74,32,28,25,21,13,16,17,13,25,20,16,5,22,27,59,40,25,27,9,20,29,23,19,18,12,18,11,19,19,26,29,24,17,11,27,22,13,12,23,22,14,18,19,20,27,10,9,13,23,30,21,20,15,16,19,21,15,30,35,24,19,17,15,31,19,20,21,24,20,25,24,33,32,18,12,10,25,24,26,22,18,12,17,23,24,17,22,11,14,10,18,22,27,21,17,8,14,16,22,17,16,12,22,11,25,28,25,19,29,16,12,24,20,19,23,17,13,17,45,17,27,23,17,0,16,14,24,19,23,15,29,10,19,20,20,21,19,8,18,0,0,13,15,19,14,16,15,15,10,12,10,18,14,9,13,10,13,21,14,16,12,16,13,15,17,21,24,12,12,14,21,9,6,11,12,16,10,9,7,6,8,16,17,7,14,20,9,11,15,12,19,14,8,13,8,10,8,12,8,18,7,12,11,13,6,10,9,10,8,8,10,21,11,12,9,10,14,19,15,11,3,9,17,20,22,8,10,13,11,14,18,23,12,13,10,5,7,18,14,10,15,10,6,6,8,17,16,21,10,14,10,13,12,12,27,13,19,9,13,23,9,26,15,9,10,22,19,18,16,19,14,9,17,16,27,14,20,24,16,23,29,38,22,22,26,27,23,22,13,20,13,13,5,15,24,23,12,15,8,10,20,10,18,19,10,8,16,14,23,25,22,19,2,15,28,26,26,18,10,7,9,12,18,17,19,6,24,14,16,19,18,25,18,8,7,17,20,9,14,22,7,12,6,20,46,23,6,9,6,8,16,12,9,5,10,8,11,20,13,5
2016,15,14,6,16,13,19,23,30,9,9,26,13,17,19,12,5,7,9,15,9,9,9,14,14,11,11,13,9,18,9,10,15,23,20,11,11,8,8,11,20,10,15,12,8,14,16,11,7,11,12,6,8,15,15,14,14,20,10,16,18,36,13,19,33,11,20,16,68,21,27,35,18,9,18,14,19,10,10,13,8,18,14,19,14,17,4,17,8,23,13,21,14,15,14,18,16,19,19,25,15,14,16,34,28,20,16,12,15,22,26,11,21,14,17,18,22,39,31,36,13,24,21,36,24,22,17,21,15,12,29,35,29,19,16,24,14,13,17,10,13,17,19,21,24,19,11,17,5,6,19,19,18