2008,26,51,41,50,31,26,64,56,63,53,47,38,15,63,72,79,62,59,44,25,334,83,85,86,51,33,48,76,66,101,87,51,29,41,75,79,64,96,65,30,33,76,85,66,72,71,41,23,228,91,61,57,68,40,35,76,83,84,104,74,24,38,81,90,68,72,54,27,43,85,80,94,91,76,28,28,91,97,83,88,63,43,35,66,74,88,92,81,52,46,68,101,97,94,64,43,45,107,104,105,101,77,58,56,79,93,97,85,82,56,49,116,92,95,90,59,51,43,69,101,90,58,69,60,50,71,101,86,66,58,34,48,76,78,89,78,90,60,44,121,77,77,74,61,42,29,111,95,81,67,82,33,43,82,92,71,72,95,32,40,77,127,95,111,70,48,49,74,90,114,95,92,28,33,96,98,71,70,62,61,38,91,78,80,80,54,23,37,96,82,75,59,56,23,25,83,80,47,73,43,35,26,59,71,56,74,67,22,10,65,64,82,71,51,24,36,56,63,89,67,67,27,41,92,69,77,72,60,32,31,77,70,68,72,42,36,19,50,68,65,83,75,52,38,52,83,77,84,73,40,43,64,84,74,92,72,38,37,86,97,78,62,61,53,51,104,81,74,78,72,32,43,92,57,70,57,78,42,58,82,100,82,76,68,39,29,99,70,111,93,81,57,46,79,96,109,87,77,38,48,73,73,90,92,73,43,47,85,102,84,106,82,41,44,110,75,76,114,76,36,51,94,100,84,93,106,49,49,110,90,87,67,61,36,52,94,107,106,91,86,59,85,75,97,88,111,70,50,41,77,54,77,81,69,46,39,80,69,33,50,37,36,24,53,50,59
2009,24,37,40,49,92,78,64,94,86,45,70,83,100,114,105,100,59,46,94,81,107,66,79,36,47,71,75,116,113,122,43,55,102,92,91,95,82,30,65,86,95,109,98,94,60,41,95,130,126,79,92,60,61,117,125,145,121,106,50,61,122,136,106,110,105,52,68,106,90,123,114,86,43,79,149,123,121,145,105,57,46,89,133,92,116,61,67,54,109,114,140,111,108,44,52,104,92,106,93,84,41,55,70,94,88,107,117,44,46,92,108,108,77,103,52,67,111,112,103,121,54,42,61,83,109,117,128,108,52,44,106,114,89,127,84,60,40,111,107,92,85,104,40,39,77,100,110,120,97,49,49,78,115,145,104,83,67,68,134,104,84,99,78,54,46,91,90,122,126,135,65,59,116,115,96,116,79,68,48,123,105,112,86,99,44,71,68,118,108,107,89,70,51,97,124,77,134,85,54,65,111,127,96,86,77,54,52,91,86,122,79,85,35,64,90,75,107,120,68,41,40,114,93,76,74,87,31,59,78,93,87,94,89,47,48,91,80,86,89,79,29,50,91,80,109,93,86,40,63,119,127,107,98,89,43,64,87,109,119,125,102,46,54,99,43,64,87,109,119,125,102,46,54,92,73,48,46,87,130,106,114,118,79,41,108,150,104,150,117,84,60,117,127,123,119,147,61,98,120,132,142,161,108,57,43,113,138,134,129,107,61,50,123,148,120,142,123,43,63,116,97,123,124,85,66,57,100,97,124,126,74,61,113,135,126,115,121,98,63,100,118,114,127,106,108,61,60,126,94,103,84,67,64,32,67,114,71,36,40,46,51,74,51,82,48
2010,22,63,41,73,72,108,111,112,48,49,102,101,97,84,92,57,70,93,119,124,133,79,84,84,114,98,124,148,110,89,73,127,123,108,118,131,56,61,96,136,127,110,102,54,61,96,91,122,112,100,62,67,103,130,111,116,97,84,79,127,118,104,109,101,78,68,122,130,111,108,148,111,66,121,120,103,129,104,62,82,119,130,123,126,123,79,74,118,141,141,138,95,84,67,98,132,108,131,113,64,80,134,141,127,129,94,77,91,148,98,144,118,142,89,77,117,114,116,121,122,61,58,110,147,141,104,123,80,94,146,121,99,99,97,69,67,110,102,101,112,108,58,73,112,119,89,114,75,62,50,78,109,118,135,92,53,66,118,115,104,92,73,119,111,109,102,151,109,94,66,80,148,98,128,105,94,54,64,102,96,111,100,93,46,57,64,94,81,94,81,56,63,51,90,93,86,65,49,47,86,85,96,89,113,46,62,111,134,121,129,106,72,58,86,131,120,128,111,54,61,120,94,123,155,100,72,84,121,133,114,116,115,81,63,132,154,135,151,94,53,47,127,132,123,123,93,52,94,117,122,107,109,120,67,80,111,123,132,124,146,44,67,129,113,132,140,192,65,85,149,155,156,128,94,55,49,150,144,142,153,132,81,76,125,157,149,148,145,67,88,131,160,156,143,141,62,71,165,164,156,155,111,40,77,145,129,130,137,106,81,82,151,164,144,127,92,96,72,126,131,137,126,132,79,88,156,183,137,114,94,65,97,152,142,160,149,119,69,92,138,168,127,133,96,71,91,149,114,167,124,118,60,59,102,98,106,80,34,40,30,45,66,52,78,77
2011,32,47,79,90,110,109,84,66,59,142,166,120,158,127,63,80,136,124,134,134,134,59,71,172,161,153,126,117,58,62,112,118,140,130,116,83,60,110,128,132,143,88,60,73,126,127,123,152,118,72,65,129,128,154,123,119,64,113,140,147,130,143,124,90,59,157,151,126,143,117,81,70,118,144,106,146,96,59,47,124,134,142,122,93,55,74,128,116,119,97,99,61,71,143,129,114,145,114,69,71,127,109,126,134,106,56,78,102,139,128,98,111,69,78,121,149,142,125,104,47,70,108,118,114,112,117,86,83,128,145,134,131,102,79,63,109,123,113,108,105,47,62,144,121,121,117,93,64,63,106,95,89,87,105,49,61,115,133,149,125,90,103,84,148,138,157,137,112,49,84,176,134,120,113,109,57,63,96,115,118,98,113,60,50,98,100,115,119,102,52,44,123,108,84,115,92,55,59,116,110,104,106,108,64,47,95,111,91,87,76,59,37,121,106,85,96,81,49,50,100,94,109,107,66,46,44,82,98,91,75,72,48,52,91,108,75,83,79,48,44,89,67,98,113,89,42,48,91,94,106,85,90,63,55,97,123,129,126,73,49,61,89,103,117,174,91,45,64,117,94,116,126,99,73,85,121,127,148,143,128,74,83,121,123,145,138,114,74,62,150,153,125,125,94,62,79,139,128,134,132,146,76,71,140,122,156,140,124,70,77,134,140,150,159,130,73,57,143,163,160,151,132,95,96,149,167,138,111,92,81,93,140,135,154,139,118,58,73,175,126,142,120,135,90,93,136,171,131,134,99,56,74,128,107,108,90,0,0,0,28,60,90,78,66,44
2012,52,83,111,103,137,120,54,67,118,154,157,129,130,75,98,147,147,107,152,136,64,87,129,120,115,96,111,65,70,150,120,149,120,124,67,88,146,138,132,134,137,75,75,129,165,165,171,149,77,99,127,140,151,135,128,90,74,152,135,150,159,135,77,83,159,160,181,146,148,73,76,132,160,159,194,149,69,97,140,169,154,140,115,63,77,173,166,156,144,129,81,91,131,166,133,161,121,70,88,136,120,158,148,122,56,93,143,161,135,154,133,75,93,147,148,140,160,112,84,77,129,125,157,143,126,71,87,150,145,143,123,114,65,122,157,167,170,94,135,73,90,154,148,165,162,137,58,67,90,134,127,139,115,67,66,198,152,160,158,137,80,101,171,156,163,140,159,80,120,154,168,160,144,128,73,99,118,129,124,116,125,56,62,125,150,101,106,93,64,56,131,124,126,106,113,57,62,114,123,147,104,95,44,63,110,139,119,121,87,48,49,130,114,115,93,90,48,47,121,130,117,92,91,52,58,107,98,120,76,101,46,53,141,140,118,89,84,55,50,132,122,107,133,101,50,68,106,132,121,141,109,52,93,152,173,141,151,120,52,50,146,116,141,134,144,67,79,132,166,161,170,138,68,79,161,145,129,186,128,74,77,129,162,158,145,124,85,93,168,160,138,146,123,77,78,130,138,94,136,130,82,81,127,167,148,111,149,63,101,135,147,129,131,101,61,76,147,140,133,161,119,75,78,149,152,145,118,97,84,75,114,161,185,133,153,91,85,136,155,160,141,131,86,89,159,141,168,149,132,90,96,122,120,127,120,80,44,64,69,57,61,80,62,58,54,75
2013,48,102,113,111,66,81,135,137,129,137,122,76,70,141,145,137,164,154,99,93,149,173,160,173,143,66,88,186,235,189,184,134,65,90,150,151,147,138,97,64,78,159,163,152,146,145,68,82,167,181,179,169,154,110,85,166,204,167,197,142,91,105,177,198,186,202,131,228,114,172,190,199,220,184,74,123,173,155,176,156,160,90,111,161,123,171,123,97,90,80,119,154,172,156,132,89,117,208,172,159,201,156,94,81,174,169,195,150,135,101,117,211,196,158,160,153,75,104,171,162,130,166,156,113,122,209,190,137,135,111,103,94,172,136,163,157,148,93,91,153,196,172,181,133,76,88,161,179,176,150,123,99,103,191,215,205,167,137,96,117,172,151,198,199,176,88,99,187,185,196,175,108,79,94,163,165,151,188,121,72,88,148,127,132,121,106,52,62,114,101,141,117,130,39,81,139,117,119,137,121,53,59,125,97,39,106,97,43,57,122,103,145,129,104,59,41,106,152,116,114,98,47,52,93,100,112,94,82,68,55,98,125,117,125,82,44,51,84,132,119,116,77,49,58,71,125,120,95,91,69,50,115,125,103,122,101,59,85,124,111,107,120,97,69,61,131,131,122,123,119,63,88,123,123,133,142,125,65,78,96,115,157,143,116,76,78,120,112,85,132,113,85,72,128,144,147,148,136,66,65,126,130,105,125,89,56,50,112,124,127,126,94,88,67,114,102,161,116,110,63,61,125,149,140,108,111,69,63,116,140,132,117,98,46,93,125,156,116,126,120,68,61,140,119,116,124,104,61,62,124,87,87,94,111,45,48,57,44,54,45,54,51,47,61,61
2014,41,74,86,64,64,64,116,115,104,112,65,61,106,158,107,114,110,56,75,117,139,119,122,131,63,55,125,125,94,129,123,58,63,112,114,154,147,116,58,67,127,118,126,123,99,64,77,140,165,160,144,125,77,82,142,142,142,131,114,84,96,128,164,157,159,132,92,73,127,155,222,163,130,72,90,166,142,120,158,136,59,65,139,153,140,135,105,71,94,156,146,136,156,146,67,71,170,159,140,149,108,71,75,135,132,157,119,94,71,59,108,148,139,147,99,65,87,154,137,144,116,113,64,80,149,134,133,134,118,77,63,129,123,129,134,93,61,89,139,158,103,138,119,65,73,107,139,289,214,128,73,68,133,156,152,135,113,58,75,140,175,143,155,110,84,86,124,127,129,147,126,56,87,124,127,114,130,97,62,56,105,107,108,134,83,70,56,131,120,91,126,90,61,43,116,109,109,95,80,54,51,81,129,93,100,68,44,46,115,113,108,81,92,62,53,139,116,126,115,95,50,48,88,160,263,176,131,61,100,125,124,134,151,99,75,58,165,123,93,113,96,86,63,98,120,120,119,99,63,69,89,136,131,147,104,58,85,134,132,149,126,134,84,78,134,132,114,143,92,60,99,158,133,151,138,86,57,71,158,167,159,180,96,69,82,135,110,242,120,108,56,59,118,150,130,135,92,53,70,142,121,115,130,100,73,86,143,171,166,167,120,69,89,143,146,153,160,126,76,84,134,138,160,136,130,56,74,139,153,159,101,82,72,71,163,151,150,118,127,81,121,132,117,166,153,102,92,75,147,157,119,111,79,56,60,79,83,75,68,71,47,55,77,89,66
2015,55,43,57,63,118,115,117,144,131,66,62,123,121,136,115,104,58,69,217,154,149,129,140,63,80,125,148,147,143,97,73,70,141,129,117,120,114,55,83,135,134,150,162,114,70,74,130,140,90,121,143,74,100,117,146,130,133,110,63,80,125,141,165,140,128,87,78,159,151,94,145,95,48,72,142,160,160,113,95,88,84,125,124,125,149,119,50,78,128,128,133,116,105,72,55,130,170,142,157,120,84,72,144,129,158,153,124,77,75,151,120,116,116,144,77,92,164,158,148,124,118,72,75,138,127,144,134,142,0,81,141,164,141,137,114,71,83,118,128,135,146,125,52,81,0,0,116,141,110,68,79,171,150,150,129,123,67,97,165,160,154,138,116,59,74,132,118,113,127,101,77,89,128,126,124,123,79,54,51,141,122,118,113,87,52,60,122,149,117,108,103,52,42,117,137,119,128,118,56,47,114,112,126,131,109,51,44,103,99,105,91,138,48,26,101,80,116,101,99,54,42,96,117,82,123,60,49,58,111,109,109,98,93,54,39,109,106,124,119,101,44,53,89,109,114,106,87,57,43,93,107,507,963,983,914,925,977,973,963,975,930,888,929,800,753,984,923,959,912,905,967,975,997,977,985,918,916,966,993,996,1003,986,932,947,979,982,999,991,963,197,60,130,115,147,98,110,55,71,135,147,114,130,111,58,61,119,127,125,110,96,54,65,110,128,138,110,114,51,63,116,139,135,132,134,64,53,122,129,93,86,88,60,58,159,103,135,113,104,61,64,114,149,116,126,85,80,63,148,134,117,105,79,54,50,80,88,60,62,40,40,42,69,62,56,38
2016,44,51,67,105,122,86,114,78,61,54,126,116,128,140,110,45,50,95,136,123,93,102,60,62,118,103,99,132,119,62,68,107,132,131,132,116,37,59,90,98,94,112,109,56,58,112,130,131,117,107,62,62,104,119,130,135,113,62,58,132,134,155,128,118,51,44,101,130,129,147,108,57,79,141,116,112,127,104,57,63,131,121,125,97,78,47,53,90,113,128,100,105,51,68,117,114,132,130,116,61,59,114,151,112,120,90,61,68,131,119,133,151,109,54,75,125,146,141,127,89,48,74,121,151,114,82,84,53,65,129,128,115,128,98,57,74,83,125,120,108,125,58,60,121,119,107,104,112,71,63,94,96