2008,47,76,74,76,57,65,98,92,113,103,93,67,61,123,119,147,162,137,65,63,111,151,147,145,86,70,81,144,166,143,152,120,76,98,159,144,157,147,143,61,118,205,209,167,190,133,94,99,204,169,174,141,165,86,79,161,158,154,181,159,60,76,137,150,189,138,137,57,94,200,212,168,182,125,83,84,161,163,154,161,109,78,52,145,160,149,137,124,87,78,147,184,154,109,148,85,91,160,161,146,87,111,48,89,148,172,111,85,68,52,51,88,66,57,78,66,49,35,49,77,75,63,60,53,43,91,75,56,91,126,92,102,156,149,127,124,107,68,78,151,143,149,152,123,75,94,134,142,185,150,127,74,78,140,162,130,133,140,68,63,144,160,149,134,154,73,70,69,79,104,106,133,48,68,131,168,105,136,98,92,84,139,138,129,142,77,51,54,135,116,130,156,155,93,80,177,149,150,143,102,52,50,148,108,141,139,115,36,44,56,48,63,69,57,26,31,58,59,44,43,47,34,39,42,95,105,119,122,73,54,113,116,92,149,91,49,44,114,131,136,124,120,73,84,66,81,93,97,80,55,121,171,143,145,128,66,43,79,98,98,86,85,87,50,68,95,101,109,82,82,50,54,86,76,104,73,100,49,71,114,81,80,97,94,106,136,222,230,201,141,107,66,86,94,141,217,169,157,121,114,211,159,179,192,166,62,75,88,97,75,85,72,46,74,91,124,100,96,95,37,74,97,171,168,145,172,75,74,77,68,76,102,108,84,121,139,149,165,133,143,83,103,102,78,83,66,54,59,62,79,68,117,86,46,40,29,52,57,50,35,34,40,52,31,54,43
2009,35,48,52,87,106,136,137,132,111,88,140,144,143,181,163,153,113,88,143,181,202,174,161,75,111,144,196,189,182,173,61,127,173,223,224,188,194,110,123,223,228,244,223,238,140,150,200,264,261,201,214,93,127,183,229,255,187,198,117,164,239,246,280,233,148,106,157,242,225,250,211,181,100,136,203,204,211,206,148,78,137,194,184,165,198,131,167,123,211,208,245,170,168,114,81,152,169,159,189,151,82,115,146,160,194,196,175,92,107,161,204,139,101,120,64,144,208,206,231,193,187,98,121,177,174,154,199,156,99,117,184,239,183,175,152,94,93,83,116,88,79,94,56,80,139,184,177,184,174,74,104,172,198,185,157,114,89,63,128,117,96,114,82,74,93,146,115,114,87,72,55,38,74,64,75,91,58,67,75,146,168,138,157,108,53,79,167,185,164,158,151,95,85,127,175,146,156,121,94,66,151,190,170,171,143,64,98,133,146,179,119,151,78,101,172,142,130,148,124,93,80,159,140,135,144,101,69,74,143,149,160,141,147,81,109,155,143,161,194,155,65,118,205,238,185,186,145,80,144,205,228,243,195,174,113,143,249,284,239,293,215,123,147,214,113,143,249,284,239,293,215,123,147,263,191,144,192,249,247,313,271,229,162,167,274,255,259,255,222,153,150,232,239,237,285,236,164,203,247,234,262,252,193,141,148,218,286,300,257,202,127,201,225,231,214,215,200,136,152,217,207,238,237,185,119,114,172,205,214,150,143,98,103,184,199,171,169,217,148,113,195,184,183,177,168,152,127,146,162,167,184,158,93,92,114,133,106,74,77,89,94,95,90,143,127
2010,43,69,87,97,132,175,167,130,101,103,168,195,202,168,190,129,146,193,233,216,210,175,172,172,236,256,204,234,194,132,151,239,269,220,245,249,122,154,202,227,249,204,218,132,167,210,245,206,255,196,129,164,203,248,182,201,189,138,155,233,235,206,234,188,129,154,227,258,228,203,221,167,163,209,218,250,194,186,140,148,224,205,209,223,189,231,126,241,190,223,223,197,136,123,167,188,232,224,204,133,132,206,218,227,228,171,161,132,214,215,249,188,193,133,127,203,191,230,169,189,116,123,200,253,218,203,206,156,171,198,189,176,170,125,123,165,171,156,164,178,175,114,114,141,204,169,178,144,130,117,133,175,163,196,138,126,99,169,164,176,172,250,166,175,169,141,118,119,138,104,97,145,135,149,120,102,92,85,127,131,126,161,106,69,68,86,123,99,123,99,73,70,109,108,136,109,106,77,79,130,120,117,144,157,98,128,201,185,203,193,164,106,91,137,184,185,202,162,116,107,171,165,171,164,172,96,98,181,232,149,188,161,114,128,193,206,209,201,167,115,113,170,206,207,224,228,107,132,230,240,227,212,180,177,152,237,298,301,317,266,144,192,281,274,269,253,303,153,182,278,362,345,350,200,172,177,294,313,311,323,271,169,215,244,330,315,341,241,177,191,305,291,295,295,222,161,204,293,292,311,280,254,127,168,287,249,237,241,205,146,195,282,233,286,204,215,153,157,224,202,222,227,201,157,143,254,240,224,200,163,106,173,208,234,228,223,185,156,200,279,256,234,218,190,156,173,239,229,244,189,196,119,94,184,153,139,123,65,72,67,104,108,110,130,78
2011,80,100,119,156,196,183,163,121,126,238,257,209,230,180,103,148,226,226,236,255,252,145,173,244,254,294,202,192,118,152,220,223,205,191,182,110,132,190,197,227,234,186,128,209,399,242,240,214,219,136,120,209,199,200,268,175,143,213,258,256,255,214,188,137,131,240,224,237,232,181,113,138,213,198,195,220,155,108,124,158,175,222,189,152,116,135,182,183,246,189,139,133,150,205,212,225,214,182,88,116,199,170,197,180,156,116,121,167,187,181,165,149,130,129,181,208,220,175,157,102,131,173,222,236,212,172,103,137,211,203,218,207,189,98,139,192,215,181,168,182,124,129,176,170,188,172,140,94,106,176,170,170,199,151,152,177,178,180,225,189,147,88,102,153,133,178,176,135,74,106,411,169,161,160,129,102,105,124,170,180,140,146,90,93,123,143,168,165,169,76,70,153,155,125,182,119,88,107,120,133,140,152,156,97,91,143,141,146,151,124,100,95,143,129,172,140,109,80,94,135,131,146,147,123,74,76,113,127,135,114,99,80,69,109,131,96,139,137,92,147,126,170,158,161,152,73,113,117,157,183,160,159,109,108,146,155,188,151,150,111,102,153,166,169,205,173,103,123,191,191,218,201,209,152,195,206,245,244,264,202,133,137,198,222,238,224,165,115,131,210,256,246,222,166,140,138,211,210,263,237,156,153,147,210,195,223,241,184,120,118,215,267,205,221,170,97,140,211,184,214,190,168,102,175,188,183,160,147,118,112,124,174,173,164,172,145,127,115,200,166,185,198,185,144,137,186,186,199,161,119,89,98,157,140,118,111,120,120,120,112,92,83,85,107,67
2012,62,95,126,108,142,134,101,93,143,165,152,167,139,99,110,152,181,148,175,176,108,119,211,206,162,170,158,124,116,226,197,258,205,160,98,123,225,186,215,193,192,138,136,199,310,254,232,193,131,134,184,188,207,214,170,119,130,212,209,196,200,197,96,139,201,236,214,177,162,117,135,182,202,187,208,140,109,128,168,177,191,184,165,87,97,164,186,185,160,158,84,115,157,218,171,189,161,119,117,161,193,195,160,144,118,133,164,179,189,198,180,102,141,165,225,177,158,119,123,127,151,141,162,154,161,94,126,167,176,199,216,172,128,168,156,180,188,145,130,93,112,202,172,188,151,151,89,93,144,167,136,155,139,100,111,141,171,161,142,146,78,94,191,154,167,146,108,96,120,134,152,146,142,132,92,123,147,150,150,132,140,76,106,139,139,146,202,119,83,90,134,125,150,126,88,74,92,131,129,173,136,107,67,89,113,138,151,115,107,77,67,130,145,131,127,107,70,59,135,115,138,92,109,79,99,107,116,140,105,111,88,61,133,132,177,124,109,86,65,172,156,124,160,117,70,106,133,139,167,172,188,115,135,191,212,190,211,172,107,127,205,182,192,180,196,84,140,234,243,230,257,197,111,172,253,256,258,291,272,113,182,192,283,292,268,197,125,145,219,189,212,257,200,125,165,215,206,197,191,168,130,126,169,223,196,190,163,104,149,193,206,214,204,156,110,135,168,156,210,182,178,115,116,209,169,162,147,129,91,122,178,183,172,282,160,87,108,192,183,205,158,135,113,129,179,200,221,191,137,115,138,131,195,145,134,95,65,62,96,69,77,89,79,62,67,84
2013,79,120,102,116,81,63,117,142,152,154,158,100,133,195,179,168,230,184,109,136,176,215,306,203,228,87,129,245,208,248,218,187,116,159,212,268,318,256,206,111,137,233,231,243,265,207,113,134,220,246,257,266,191,128,152,233,239,251,265,207,133,159,210,214,258,225,195,150,126,565,251,265,226,194,133,148,230,228,210,287,184,139,172,180,202,187,191,139,110,108,186,213,208,229,163,122,157,269,215,205,250,180,144,143,233,215,193,241,179,138,187,199,214,227,207,187,118,163,186,206,176,190,183,112,133,141,158,147,188,147,121,101,209,187,188,171,161,111,141,209,233,230,199,156,112,116,142,153,161,185,167,110,104,151,200,176,161,179,118,103,175,175,204,181,142,89,106,193,142,172,163,130,94,75,162,148,133,175,142,77,68,140,170,198,93,132,81,91,169,127,159,143,116,75,77,156,160,151,137,119,77,185,133,127,70,129,103,80,67,124,112,134,133,134,83,77,130,132,122,152,88,62,91,100,135,127,129,100,78,68,118,116,111,122,95,74,63,104,144,126,123,127,64,116,90,145,137,145,145,76,108,168,162,199,177,152,90,110,161,174,209,185,172,113,124,202,189,238,216,163,91,134,198,212,242,230,193,119,144,171,177,221,200,175,135,131,177,203,203,199,195,116,147,203,231,225,233,181,99,110,192,183,229,163,170,99,104,169,132,175,186,161,113,110,157,163,185,167,194,93,113,176,175,200,159,147,90,101,172,140,148,112,90,74,97,147,162,182,183,163,109,137,180,167,153,125,114,81,96,123,114,124,106,109,47,71,94,49,59,72,85,83,68,86,72
2014,47,94,102,62,62,62,158,135,129,167,96,107,132,181,138,157,141,92,103,141,158,182,188,175,93,126,221,186,184,166,158,84,130,158,199,274,223,164,115,162,210,198,220,195,176,109,116,167,201,266,211,174,128,126,210,198,211,177,163,126,141,217,232,237,163,145,129,145,169,204,201,161,132,97,121,185,215,191,199,178,108,99,204,161,192,155,128,133,113,182,174,192,147,161,98,109,162,180,189,201,159,93,127,167,212,173,138,126,109,122,162,193,194,168,151,115,120,183,177,186,159,109,85,110,157,168,161,181,139,94,98,133,169,171,156,121,99,100,148,170,145,139,126,83,90,139,167,157,127,114,101,86,147,164,179,143,106,94,100,156,187,157,121,131,72,75,127,127,151,155,123,75,80,144,127,149,133,130,89,92,146,119,127,101,107,56,72,130,144,160,133,112,112,87,123,133,127,135,93,67,94,107,147,125,128,143,49,70,111,98,114,114,110,72,73,127,100,108,111,112,85,69,103,126,139,141,113,65,88,127,150,132,142,139,97,79,105,154,136,157,155,76,98,137,148,176,193,167,97,125,185,174,218,219,195,98,131,214,186,246,200,188,112,153,209,201,209,240,185,140,178,238,242,285,241,167,123,162,232,218,265,298,174,105,139,215,206,210,195,166,116,160,230,241,223,224,172,119,136,208,178,203,213,166,116,175,184,217,213,194,137,125,125,187,198,216,194,205,139,123,187,193,207,174,159,131,115,169,176,169,114,112,136,96,212,199,162,154,260,108,157,161,205,222,216,170,110,134,202,214,164,160,140,80,76,134,104,86,125,116,59,96,96,129,84
2015,78,104,104,103,129,159,158,188,154,125,104,182,179,161,158,162,116,119,165,198,215,223,206,109,165,216,181,205,214,193,112,128,237,216,240,198,190,101,116,197,217,233,201,164,90,120,159,172,153,225,176,141,127,225,276,223,188,182,120,177,240,235,237,203,180,102,136,197,184,173,216,181,95,116,170,189,203,198,168,110,120,156,157,195,182,175,115,132,192,197,214,158,134,112,135,191,206,194,218,271,136,134,202,179,186,203,143,141,143,228,161,220,188,163,118,123,199,197,190,175,146,85,116,189,174,191,194,131,0,112,177,204,182,159,138,83,117,145,179,170,193,144,102,101,0,0,143,151,163,96,103,169,154,147,143,127,103,91,199,169,191,181,101,90,84,140,159,114,149,111,84,109,179,139,143,138,120,65,61,141,132,149,133,99,73,73,129,148,204,319,117,68,73,141,133,133,127,131,80,91,124,157,123,141,116,73,70,111,152,143,132,118,77,62,110,113,129,116,108,89,73,103,104,126,132,83,67,75,125,163,148,107,127,76,49,115,144,176,147,132,68,66,129,136,168,145,150,83,74,141,181,218,182,166,81,133,165,163,172,176,137,83,104,196,188,208,160,155,115,112,149,207,224,230,180,102,104,182,196,227,211,199,130,141,193,219,246,200,185,121,139,227,205,225,228,178,108,135,199,233,191,186,165,96,109,191,217,211,196,172,108,107,174,210,189,177,172,87,95,183,169,152,148,127,99,101,167,160,163,112,87,63,113,172,167,150,188,123,102,118,159,169,173,160,158,105,111,170,135,146,134,108,77,52,99,100,80,54,34,41,66,85,109,79,65
2016,40,81,72,148,130,117,145,122,72,91,143,136,184,143,151,80,84,137,173,175,196,158,93,126,218,183,202,170,180,104,111,177,205,234,205,171,83,100,154,167,194,178,136,94,90,171,173,190,198,166,100,110,175,187,211,200,178,85,114,198,236,211,168,177,98,99,188,173,173,177,180,102,128,177,181,180,160,125,75,89,126,155,138,152,89,78,66,142,178,180,165,136,93,108,165,173,183,173,143,89,119,134,185,138,148,147,72,82,182,194,171,171,142,88,106,174,153,180,160,139,100,136,141,163,175,119,110,104,115,191,129,181,167,132,77,109,125,147,156,144,118,92,116,166,133,135,119,96,91,97,92,131