2008,2,7,3,10,5,7,7,4,9,10,9,8,2,9,11,12,4,5,8,11,2,6,5,7,6,6,8,11,9,7,10,4,9,6,8,6,11,7,3,5,7,8,5,6,13,11,13,7,10,12,11,7,4,2,11,7,2,10,1,7,8,16,13,6,13,10,7,6,5,6,1,0,7,5,1,5,8,4,1,2,7,1,8,4,8,3,2,7,10,4,9,8,4,9,4,5,8,14,2,6,10,4,8,2,12,6,12,1,5,3,5,5,3,6,6,3,8,4,3,12,7,4,13,9,4,9,4,4,6,8,6,9,15,9,2,12,8,6,7,5,11,7,4,6,5,8,7,13,11,6,3,1,5,5,11,4,4,4,6,5,7,6,7,6,6,4,4,8,5,12,5,6,7,8,4,8,8,12,11,6,8,6,7,5,11,7,4,5,7,6,3,8,3,5,5,6,1,4,8,5,3,7,3,3,1,8,6,4,6,1,9,7,6,9,2,1,7,5,1,0,10,5,3,3,7,6,2,3,2,4,6,6,8,8,7,3,3,8,5,6,4,3,15,1,3,5,9,2,5,3,7,9,7,15,4,5,8,3,10,4,6,2,6,4,5,11,6,3,6,4,9,6,6,5,9,11,7,7,5,6,7,7,6,6,2,3,2,7,3,8,4,1,6,7,11,8,12,4,7,9,4,4,7,9,3,4,4,3,9,5,1,8,6,7,6,9,11,5,9,5,6,4,9,6,6,5,9,6,6,3,8,7,4,2,5,7,4,5,6,9,1,4,18,10,7,12,6,3,2,8,7,3,8,4,17,1,9,15,6,3,5,7,6,3,3,3
2009,2,8,5,11,8,4,9,3,8,4,6,6,8,9,4,12,1,4,12,12,9,12,11,5,2,6,9,2,5,2,2,8,4,6,12,6,10,0,3,6,4,5,12,9,8,7,4,14,9,18,14,6,7,15,9,7,10,8,8,9,11,9,6,16,5,4,6,7,9,2,12,8,8,18,9,10,10,14,9,15,11,15,15,13,10,6,6,3,6,5,9,16,8,11,11,10,9,24,1,11,5,6,4,11,9,8,8,10,5,5,14,4,3,2,3,14,3,4,7,6,12,9,3,2,6,3,10,22,7,3,4,5,5,7,11,5,5,12,0,5,3,11,6,10,8,8,14,11,4,12,4,9,7,11,4,6,9,5,9,7,13,8,3,4,2,3,16,9,16,10,8,3,9,12,4,8,7,6,8,3,3,9,3,12,3,1,9,6,22,7,6,9,0,4,9,7,7,10,12,11,7,7,13,8,9,5,8,4,10,6,2,8,6,4,2,8,10,6,7,4,8,6,9,6,9,14,9,7,3,11,7,12,4,10,4,13,3,4,10,7,2,5,16,12,8,9,5,10,10,9,4,4,9,6,8,4,5,7,14,10,4,5,7,6,8,4,5,7,14,10,4,5,7,8,9,6,7,8,4,9,6,6,8,3,4,8,5,8,9,10,9,6,3,10,8,12,5,7,4,9,4,7,6,3,6,10,12,5,7,12,7,9,4,8,9,10,8,12,7,7,3,6,6,8,27,12,14,9,15,10,5,2,5,9,9,9,8,4,7,6,4,5,5,9,5,7,3,2,2,7,6,7,9,7,4,4,8,6,4,5,4,7,4,6,16
2010,1,5,12,4,9,8,4,5,5,4,8,6,7,6,4,12,7,5,16,11,12,9,10,10,10,6,3,4,10,14,6,9,7,16,12,35,7,8,13,8,9,11,14,11,11,8,9,4,4,16,14,3,7,14,9,9,11,13,3,6,7,5,10,9,10,10,13,20,13,22,23,26,24,20,17,28,15,23,24,20,23,18,29,19,10,17,13,20,20,23,24,17,16,14,13,16,44,28,17,17,12,21,12,19,20,28,21,19,19,19,24,23,23,14,15,16,20,15,19,12,10,12,12,23,15,23,15,12,10,17,19,22,20,15,16,15,22,12,20,19,17,15,22,22,18,8,14,3,11,10,12,8,11,16,21,9,20,8,11,19,15,14,7,15,20,9,13,11,13,12,10,15,17,16,20,7,5,6,12,17,22,7,11,12,18,13,10,10,10,10,25,8,16,4,19,15,11,5,12,17,19,13,21,13,12,19,21,12,20,18,16,20,13,17,19,15,16,18,18,15,19,19,18,22,12,14,19,31,17,15,24,19,25,15,27,19,12,10,17,17,8,15,16,10,17,17,10,22,14,16,16,18,15,16,19,17,23,24,14,23,18,10,15,17,19,15,19,7,10,20,25,19,25,9,15,14,21,6,17,11,11,18,9,12,23,18,15,19,17,12,20,24,21,24,17,17,14,19,16,17,15,11,14,12,10,11,11,20,13,10,7,16,18,20,17,13,11,12,12,14,9,14,16,13,13,10,16,21,19,7,10,10,15,13,12,10,11,16,11,11,10,19,17,10,9,11,7,16,16,12,12,20,14,11,14,12,11,10,3,5,9,10,5,11,8
2011,4,8,11,6,4,4,8,6,3,7,15,12,12,10,17,15,15,6,12,23,14,11,16,12,14,11,13,10,9,12,12,17,9,11,14,5,12,11,18,23,8,7,6,16,13,10,7,10,20,9,10,14,11,15,13,13,11,12,8,8,13,17,8,5,14,20,9,8,12,6,7,2,12,5,9,12,7,3,0,13,10,94,533,305,118,43,21,20,8,17,19,10,8,16,12,11,10,11,7,11,12,20,9,11,4,13,12,7,5,5,11,10,6,5,10,14,12,3,12,10,9,7,10,8,11,8,8,10,9,9,12,12,9,9,8,10,12,10,4,6,8,12,5,12,18,8,12,7,4,7,10,7,10,8,4,8,15,4,6,9,11,6,5,9,0,10,7,6,6,4,7,9,7,4,3,7,11,16,7,12,13,9,9,7,7,11,26,25,8,6,6,10,7,9,7,9,7,7,8,10,18,9,5,7,5,7,10,9,8,6,7,6,9,8,5,9,8,13,10,12,20,7,19,7,7,9,8,13,8,6,2,13,7,8,6,5,11,10,12,10,4,8,7,4,6,7,11,2,9,5,7,11,3,7,13,9,12,14,8,11,14,10,8,7,4,10,4,10,8,7,13,11,9,7,11,11,10,19,11,11,13,8,12,12,18,14,9,7,3,9,10,6,13,9,9,12,14,5,5,9,10,7,7,9,14,19,7,12,7,13,15,21,8,12,11,8,6,16,23,23,21,12,18,16,21,24,22,32,25,23,26,7,6,14,5,21,9,9,9,8,12,11,5,15,10,18,7,13,13,13,4,12,15,8,8,6,0,0,0,2,8,7,7,4,12
2012,11,7,11,8,11,7,6,4,13,15,9,10,13,11,13,10,15,7,16,12,8,14,12,14,12,10,15,12,8,7,13,7,11,9,18,14,11,32,9,7,15,9,9,13,14,17,11,9,11,15,11,14,10,7,10,7,8,9,9,18,13,9,5,5,13,7,7,13,5,14,13,7,10,10,13,7,26,12,10,15,20,15,24,24,11,10,9,7,10,24,6,14,13,12,8,13,5,7,5,7,7,13,14,4,11,8,6,32,11,7,10,10,6,7,11,5,9,12,17,6,20,13,9,5,24,19,9,8,13,11,5,12,9,10,16,10,15,11,23,7,4,14,9,19,18,7,16,10,5,10,11,15,14,9,15,8,10,5,12,9,4,4,13,9,6,11,13,10,5,9,10,11,12,14,18,15,7,11,19,12,13,7,15,9,12,11,10,14,13,6,11,10,11,8,15,13,16,13,12,12,11,7,4,7,10,8,10,12,13,8,8,12,8,13,18,16,8,10,8,11,13,9,9,7,5,7,7,8,15,14,6,7,13,10,6,9,35,5,9,9,9,10,10,12,10,5,9,12,8,6,9,8,9,13,6,11,12,10,9,14,11,11,5,8,11,14,8,14,9,9,10,8,4,7,6,10,11,13,7,11,11,9,13,12,6,13,11,7,14,14,16,11,16,5,9,13,13,5,17,11,15,17,12,6,7,14,9,9,13,13,6,13,10,9,7,22,6,8,16,14,5,7,8,15,13,11,12,16,9,10,10,8,8,9,8,15,6,19,10,8,7,10,10,16,16,11,9,11,3,17,15,55,10,13,10,2,7,10,8,8,5,6,10,4,11,9
2013,5,8,12,13,5,2,6,3,5,11,15,6,7,10,11,14,9,8,5,5,1,11,11,10,2,16,11,11,6,12,13,12,4,5,8,4,6,9,8,7,7,6,5,9,16,10,8,9,5,10,4,15,8,11,7,8,7,10,5,11,12,13,9,18,15,9,19,11,5,13,9,16,12,8,6,8,8,7,5,7,9,15,5,16,12,10,15,4,11,7,11,8,13,21,8,9,3,12,9,6,10,20,2,5,13,20,18,12,14,3,13,8,9,13,24,5,6,12,8,10,18,18,10,6,7,12,11,12,13,12,15,10,16,8,16,12,4,9,11,19,12,19,10,17,3,8,16,13,14,12,13,6,6,17,13,7,13,19,7,9,10,11,10,12,11,11,7,5,11,12,8,4,7,12,7,10,9,12,8,3,9,7,12,10,7,11,3,11,21,15,12,7,9,9,4,12,4,8,7,9,14,15,10,15,1,13,14,8,8,12,9,7,6,8,7,12,9,10,4,11,5,4,10,9,2,4,6,6,7,5,15,20,7,7,7,8,9,6,5,15,12,8,6,6,6,4,3,10,4,4,6,3,9,3,8,6,6,7,6,5,5,5,9,11,7,9,9,7,4,11,5,5,15,15,7,9,19,8,4,9,4,6,8,6,9,7,6,6,11,5,5,13,6,8,6,11,12,4,5,8,8,19,8,6,12,7,5,5,11,16,2,5,6,7,10,10,5,12,7,6,5,13,10,5,6,11,5,4,7,7,3,3,3,4,4,5,8,9,10,5,3,9,12,8,6,15,4,9,5,8,8,6,8,4,8,4,6,10,3,10,5,4,11,14,7
2014,6,3,12,10,10,10,10,18,13,13,6,13,5,4,15,9,15,6,5,7,14,12,12,14,10,10,6,4,6,9,5,4,3,6,8,10,11,8,10,19,5,15,12,7,7,19,7,9,11,6,8,5,9,8,6,10,10,4,10,12,5,7,9,11,12,9,10,8,3,11,18,9,8,12,17,9,16,6,9,7,3,9,9,8,10,13,12,11,10,10,24,9,14,10,4,9,8,22,8,13,11,14,10,9,16,14,3,10,11,13,9,18,9,10,13,17,15,16,9,10,11,12,11,13,11,15,12,11,15,14,5,15,14,9,9,15,7,9,16,9,4,11,11,15,8,15,6,10,10,12,8,8,11,8,11,9,12,6,7,8,13,8,8,7,7,8,6,2,5,13,11,1,1,9,4,17,15,2,6,8,11,7,3,6,9,4,13,10,11,9,10,14,10,11,7,7,15,15,6,7,3,19,10,9,15,9,5,5,7,10,6,7,13,10,6,8,15,11,10,15,13,14,3,10,9,18,18,10,5,12,11,11,7,11,7,7,16,16,6,13,7,9,7,9,3,8,11,10,6,10,10,7,13,8,11,4,5,11,8,10,14,5,11,6,11,7,18,7,14,6,11,12,6,11,2,8,6,8,10,13,10,14,5,9,8,16,7,7,9,10,10,10,20,5,13,14,10,16,12,18,9,14,3,7,8,12,14,4,8,11,8,12,10,9,11,14,13,14,17,14,18,15,11,12,17,22,13,10,10,15,14,16,8,11,7,17,14,8,12,11,10,10,8,8,15,11,12,13,17,8,11,13,7,13,7,7,11,12,9,5,6,10,25,9,8
2015,13,6,7,3,14,11,13,12,0,6,3,9,9,17,13,5,8,13,12,13,12,4,13,8,9,20,14,13,13,17,9,4,8,7,13,9,15,20,4,8,18,7,10,8,13,19,8,4,7,12,4,6,6,15,12,6,8,8,9,11,12,19,8,7,10,13,12,17,21,15,8,18,10,11,8,12,11,4,8,14,6,12,17,11,16,14,18,14,14,22,9,14,9,18,10,10,9,16,8,11,14,11,12,11,8,11,13,9,8,8,13,20,18,17,10,11,13,12,12,11,10,9,9,25,14,8,8,14,0,7,12,6,14,19,5,11,12,17,15,8,17,9,11,14,0,0,7,17,12,9,10,9,13,11,17,10,9,6,9,6,13,16,8,5,3,5,4,3,6,3,19,4,5,8,4,4,3,5,2,6,7,8,10,11,5,3,6,5,13,5,14,2,5,13,11,17,5,12,25,5,8,10,4,9,4,17,0,8,14,11,6,11,12,4,2,21,17,14,5,9,4,8,4,9,8,5,3,6,4,9,6,2,6,7,2,2,8,9,5,5,6,3,3,9,7,12,7,7,3,9,9,9,8,2,8,8,7,7,8,10,12,10,3,8,7,4,10,18,4,4,15,8,9,10,9,5,12,7,13,12,12,9,2,0,15,10,11,9,5,13,9,8,9,11,20,10,10,7,14,15,14,16,8,6,5,13,10,18,8,18,8,6,17,10,6,7,14,7,3,8,10,7,2,4,11,4,10,5,8,6,5,1,4,6,8,9,6,3,5,6,5,9,3,2,8,6,4,2,3,5,3,1,3,6,5,8,2,3,3,3,6,4,1,4,0
2016,2,2,1,1,3,3,1,7,2,3,7,1,7,4,2,5,4,1,3,5,5,5,4,1,4,9,5,5,8,3,2,12,4,2,5,2,1,2,6,6,5,4,4,1,3,9,3,4,0,5,7,3,2,2,2,7,12,2,1,7,9,9,5,3,3,2,1,1,3,5,7,5,7,2,4,4,0,7,1,5,8,4,6,0,2,5,4,3,2,3,7,4,7,4,4,7,9,11,4,5,0,4,2,9,7,2,6,1,2,5,3,7,3,3,6,4,1,10,8,10,3,7,5,4,1,6,5,3,2,3,8,5,6,4,3,6,7,9,8,6,9,2,0,6,4,4,4,7,3,3,4,5