2008,7,12,12,9,7,7,9,15,11,17,9,7,17,25,12,10,17,8,12,15,9,9,15,17,10,12,16,17,21,23,17,10,6,12,8,9,17,15,16,8,9,22,8,17,26,12,5,8,20,9,14,18,15,11,11,14,12,11,17,9,6,15,14,9,10,8,9,9,17,15,13,11,15,8,10,14,13,21,15,10,11,7,6,16,9,9,13,8,7,9,11,10,7,11,10,13,13,8,15,12,18,9,14,9,9,20,5,10,8,5,18,10,12,4,13,15,12,13,6,10,19,19,9,10,3,12,7,17,19,13,14,14,10,12,6,15,14,5,12,15,9,9,8,5,13,15,8,14,8,17,7,7,9,17,11,11,12,11,16,11,11,24,9,19,6,5,10,16,8,15,9,10,3,5,9,8,12,19,14,14,15,12,5,9,5,12,13,14,10,10,7,5,7,10,6,10,10,13,6,9,7,7,8,10,15,18,11,24,5,11,6,10,9,13,14,5,10,21,14,4,7,15,12,19,17,4,13,8,8,10,10,8,9,9,7,7,8,9,3,12,11,9,16,12,11,9,7,14,15,8,6,16,12,5,16,14,17,15,27,14,14,14,18,14,15,13,16,11,15,16,20,9,18,10,16,9,16,12,20,7,26,11,18,16,13,15,14,20,19,17,14,5,15,24,16,9,11,12,13,10,13,19,15,12,2,6,9,19,22,17,19,13,12,16,13,21,16,13,22,14,21,10,9,13,22,14,14,9,11,13,15,10,10,14,12,14,12,12,13,13,13,9,17,14,12,14,13,10,13,14,14,9,2,9,14,11,13,10,8,7,15,11,13,7,6,7
2009,6,8,9,8,9,16,16,12,11,12,14,14,13,10,13,14,7,8,11,9,14,7,15,11,15,10,26,21,19,31,6,18,19,14,13,14,13,13,15,11,13,17,9,18,8,12,8,13,9,5,7,14,19,18,27,21,16,37,40,25,47,61,22,13,12,8,11,6,14,19,12,18,21,14,10,16,14,22,15,11,15,11,22,17,12,13,11,6,9,17,5,11,17,17,9,15,14,9,5,8,9,9,10,5,11,14,4,5,7,9,12,12,9,6,16,4,9,8,12,14,11,9,12,10,17,8,11,9,7,9,7,8,9,15,8,6,12,12,11,10,11,7,8,18,11,5,19,13,14,13,6,10,8,14,5,6,13,6,13,16,8,5,6,6,8,9,9,9,16,16,5,6,18,6,9,13,6,12,16,12,11,5,22,4,3,4,12,4,13,12,8,5,8,5,13,8,8,10,8,8,10,8,16,10,8,4,16,5,7,16,9,8,5,9,8,5,9,13,15,11,9,7,11,18,7,5,8,16,16,12,5,8,4,4,5,7,12,5,6,9,12,6,7,17,13,12,9,10,17,3,11,12,7,19,6,8,12,7,13,15,8,18,8,19,6,8,12,7,13,15,8,18,8,5,18,6,9,8,27,15,11,5,10,12,14,10,5,10,13,15,8,12,10,11,11,8,12,11,10,15,12,10,13,8,9,6,13,10,17,17,10,9,12,3,4,12,11,16,9,9,6,10,5,14,16,7,15,1,5,7,10,11,7,5,9,14,8,7,12,6,5,6,7,4,4,12,6,7,11,24,4,12,7,12,6,4,12,1,10,8,10,7,4,8,8
2010,4,16,8,7,3,5,9,9,15,12,17,11,3,7,10,10,6,5,12,6,8,15,14,14,12,12,6,7,14,1,5,7,11,17,13,13,13,20,11,7,4,17,9,7,11,9,11,8,16,10,7,24,19,32,15,33,29,40,14,9,10,5,5,11,13,5,11,28,17,13,16,13,16,18,13,11,9,19,22,16,13,15,22,20,16,7,12,13,12,16,11,9,14,16,10,13,30,15,17,13,7,8,12,12,13,18,17,12,14,12,17,16,9,13,9,17,21,15,18,15,8,13,19,13,10,12,20,9,10,20,22,18,8,9,17,20,7,11,6,11,16,8,13,10,7,15,11,10,11,5,11,10,10,14,23,7,9,8,13,13,13,10,14,13,8,16,18,14,9,14,11,7,10,11,8,10,10,8,12,7,13,9,15,16,16,10,6,11,6,11,19,11,8,17,6,13,7,11,15,3,8,11,5,15,18,30,16,9,12,15,19,10,6,31,16,11,9,7,14,14,25,32,8,19,11,13,21,17,6,10,15,10,14,10,18,13,14,7,13,4,6,13,7,17,11,22,14,12,14,8,15,12,14,9,9,12,15,14,11,7,6,10,13,20,23,6,16,6,9,19,20,21,16,9,8,3,10,12,6,10,17,23,12,7,29,9,17,18,9,15,16,22,18,9,18,8,18,11,12,11,22,23,8,14,13,12,13,12,16,18,12,16,8,16,8,12,13,7,16,13,8,11,10,17,11,7,6,13,10,20,7,11,18,12,10,10,12,7,6,10,10,11,9,12,11,8,6,13,11,10,9,18,8,5,13,9,7,6,13,4,2,5,7,11,4
2011,2,4,2,5,5,5,7,15,5,9,14,14,13,12,15,4,6,9,13,16,10,17,11,17,10,15,8,3,15,12,6,10,11,13,8,10,9,8,13,10,12,11,3,7,7,10,11,7,10,14,9,10,9,14,14,9,13,17,13,7,9,8,11,3,3,6,9,9,15,12,7,11,11,10,7,11,4,8,7,11,3,9,8,13,8,4,9,8,10,3,9,19,6,9,4,16,12,5,9,3,17,17,11,6,5,6,14,5,9,6,9,9,2,4,13,8,5,9,4,8,9,16,9,3,7,9,8,5,9,12,4,12,12,11,10,7,8,9,8,13,5,5,9,6,9,5,9,7,5,5,12,5,4,9,6,7,12,7,11,8,6,8,8,3,5,6,8,9,8,10,5,6,10,5,11,9,3,7,10,9,5,14,12,19,4,7,7,8,7,11,13,8,11,5,5,7,8,8,8,4,10,6,4,12,5,7,10,13,9,8,13,11,4,11,6,5,5,10,10,13,9,10,10,9,9,9,7,8,3,13,11,7,9,5,8,8,13,5,8,7,9,7,8,12,12,10,6,5,5,8,5,8,7,8,12,7,6,5,15,19,4,10,6,10,6,6,12,6,7,8,10,4,12,13,9,9,13,13,11,4,3,13,9,11,11,11,10,7,9,11,12,11,12,13,7,5,9,17,8,9,6,15,12,15,10,10,14,13,7,12,12,5,15,10,19,3,5,8,8,19,13,12,13,20,13,11,14,22,16,23,15,5,15,8,7,10,15,9,10,11,3,7,19,7,4,13,11,6,4,12,10,10,8,9,10,9,0,0,0,2,14,10,11,21,7
2012,8,10,7,8,7,3,11,15,23,4,9,9,11,4,12,14,9,6,6,11,8,24,18,16,11,10,6,1,11,15,16,11,5,10,7,9,10,6,8,8,13,9,15,7,4,8,13,10,16,4,8,10,7,15,11,5,5,7,7,3,9,12,9,6,9,19,8,13,13,13,8,12,5,7,7,11,12,10,8,14,18,9,4,7,8,12,10,31,23,15,8,19,4,14,14,12,8,6,13,14,13,13,7,6,8,16,7,8,12,11,14,13,4,12,6,14,10,9,6,8,22,14,3,9,6,8,4,13,12,4,7,7,11,7,8,7,8,7,9,7,5,5,7,14,3,5,4,1,6,3,9,7,6,11,6,6,7,3,5,6,13,1,4,7,6,6,6,6,10,8,11,8,8,9,11,6,6,3,5,6,8,7,7,5,7,2,4,4,3,7,6,8,6,5,4,5,6,6,13,4,2,4,2,9,11,10,5,8,10,7,3,10,4,8,12,6,3,5,5,10,3,6,1,4,2,7,12,8,8,6,7,6,4,9,8,10,7,8,9,6,15,9,10,7,8,2,7,9,7,18,5,13,6,8,4,6,8,12,9,9,8,4,7,6,10,7,4,7,11,5,7,4,1,1,3,7,7,11,7,11,3,5,5,8,3,4,3,4,3,16,10,6,3,12,1,11,8,5,9,2,8,10,9,5,12,12,10,7,7,8,25,6,20,13,14,15,10,8,8,7,5,9,7,9,13,10,3,11,11,7,12,9,4,9,5,9,6,19,2,6,7,9,4,5,5,7,4,7,3,14,9,10,5,2,5,8,12,7,6,9,8,3,8,4,6,11
2013,10,5,8,3,5,13,7,3,8,4,7,5,6,5,12,5,11,10,9,6,5,9,13,5,4,2,6,5,9,5,7,4,4,8,12,13,6,3,3,3,5,8,6,1,3,3,12,14,6,11,11,6,8,6,9,11,4,6,10,8,8,9,10,7,7,12,12,4,7,7,3,9,6,4,5,1,3,9,6,4,14,7,9,9,11,10,11,8,7,1,6,10,4,6,8,5,10,6,0,2,4,4,1,9,2,9,7,3,14,11,14,9,13,18,3,8,3,5,6,8,8,4,6,5,3,8,7,4,2,4,1,6,7,6,5,6,8,9,9,9,6,4,9,3,11,13,5,10,4,6,5,6,4,7,12,5,5,9,5,3,14,4,2,11,5,13,4,6,9,8,10,6,10,3,5,2,3,10,7,7,7,4,9,5,11,5,8,8,3,6,8,9,11,6,4,5,11,6,7,4,11,6,6,4,1,6,13,9,3,5,4,4,1,4,7,7,4,2,8,2,6,4,3,12,6,9,5,8,5,5,8,8,6,2,4,6,5,3,4,4,4,5,4,2,2,5,4,4,5,5,5,1,6,5,4,3,4,2,3,5,5,7,7,4,4,4,5,8,7,10,6,5,2,6,8,12,4,9,10,6,9,8,8,11,2,6,9,6,7,2,9,6,2,8,7,7,7,1,8,3,5,8,9,10,2,4,5,4,1,4,3,5,2,5,1,7,2,3,6,3,12,5,6,3,11,0,11,13,9,7,7,4,5,5,6,11,7,3,4,4,8,4,7,3,8,5,3,10,9,1,2,4,3,7,5,5,3,7,4,6,3,7,7,5,2
2014,4,2,5,9,9,9,5,6,3,3,10,11,8,10,3,1,7,2,5,10,8,5,9,8,7,2,7,2,2,2,0,4,7,1,7,9,9,4,6,7,6,4,11,5,12,4,1,3,9,8,7,3,2,4,4,2,6,9,0,9,10,1,3,6,6,8,10,5,3,7,6,12,6,4,11,6,9,9,8,3,7,5,8,7,5,2,5,5,7,8,7,5,2,7,3,7,12,9,9,6,8,10,5,5,10,12,3,5,9,10,7,3,9,16,4,4,7,4,9,4,10,9,5,5,5,9,6,6,12,11,7,4,4,0,2,4,8,7,7,11,7,1,9,8,3,9,13,1,9,4,7,5,3,4,0,6,8,2,2,8,7,6,7,4,11,2,11,4,4,6,6,8,5,11,11,8,4,5,4,7,11,4,4,2,5,6,9,13,7,13,11,8,10,8,4,9,8,10,1,1,6,3,6,11,5,10,3,0,9,3,1,4,4,3,4,5,9,5,9,2,10,6,3,11,8,6,7,4,13,8,3,16,4,2,4,4,8,8,10,4,4,3,2,8,11,4,4,2,7,9,5,17,2,4,1,7,5,3,1,4,7,5,9,19,10,11,6,10,13,6,8,2,4,6,9,7,4,3,8,13,3,3,0,4,8,8,7,3,4,4,2,5,11,5,7,3,8,5,4,1,2,6,4,8,6,4,9,3,2,5,9,12,3,8,10,7,11,21,15,11,12,6,14,13,6,8,7,15,6,2,6,10,5,2,15,12,8,7,3,9,2,3,9,7,10,5,7,8,5,6,4,14,8,7,5,4,0,6,6,12,7,4,2,4,9
2015,11,3,2,1,6,7,2,5,5,5,7,6,8,8,6,7,7,9,8,6,3,11,4,3,6,7,17,4,4,15,3,3,9,3,6,3,5,8,3,6,7,3,5,6,7,6,2,5,6,6,6,2,6,9,6,11,6,3,3,7,18,6,7,7,3,7,5,5,7,2,5,3,2,5,16,9,7,9,5,2,8,14,16,7,5,2,5,5,9,12,5,2,4,10,4,5,5,15,18,6,6,8,6,6,5,5,7,8,5,5,6,3,7,5,8,2,15,8,11,12,10,9,4,11,3,5,7,16,0,5,8,11,14,4,7,13,9,9,11,5,14,3,4,7,0,0,6,6,8,6,5,11,18,4,11,5,6,3,7,3,10,13,3,1,3,6,1,1,12,5,3,2,4,9,10,1,6,9,7,4,7,7,8,9,0,4,2,1,1,7,3,2,0,3,3,5,4,4,2,10,18,3,8,5,3,2,4,7,11,5,10,10,2,3,2,3,2,3,2,2,4,4,7,3,8,4,3,1,6,2,3,9,6,4,5,6,22,9,3,2,4,2,5,7,5,16,3,12,5,5,26,10,16,10,4,2,2,10,5,16,7,8,7,2,5,8,6,4,4,3,5,5,10,5,9,4,8,8,5,3,7,5,9,3,8,6,25,4,4,1,3,5,6,2,6,6,3,3,6,10,11,7,4,6,2,9,7,7,6,3,10,1,3,12,3,4,2,6,6,3,1,3,3,2,0,2,1,4,2,2,5,0,0,6,3,2,6,2,0,3,0,0,1,1,3,0,3,3,2,0,0,0,9,0,2,1,0,0,0,0,1,1,0,1,2
2016,1,0,0,1,1,0,4,0,0,1,0,4,5,2,5,0,1,1,2,5,2,2,2,2,1,0,5,1,3,1,0,3,2,0,2,0,1,0,0,5,1,3,2,1,2,4,3,4,3,1,0,2,4,2,0,0,0,0,1,2,3,1,0,3,4,4,2,2,3,1,0,0,0,0,1,4,2,1,1,3,0,2,1,0,2,0,0,2,1,0,1,1,0,2,0,0,0,2,2,2,0,4,6,4,5,3,0,0,3,4,3,1,2,0,0,4,1,0,0,1,1,1,2,0,0,3,7,3,2,3,4,2,2,0,4,0,2,2,2,2,0,5,2,0,5,5,1,4,0,4,0,6