2008,469,867,1025,939,670,776,931,952,1123,1179,1035,625,778,1119,1227,1295,1330,1200,758,931,1380,1472,1555,1388,1169,731,946,1490,1633,1557,1542,1185,757,977,1422,1486,1359,1390,1308,784,979,1448,1597,1499,1391,1162,695,969,1347,1543,1561,1463,1128,768,960,1447,1563,1577,1329,1183,625,795,1207,1361,1392,1204,993,572,832,1187,1294,1227,1216,885,553,750,1222,1122,1120,922,704,551,590,1092,1173,1177,1081,900,556,754,1165,1274,1199,1260,989,534,768,1293,1252,1212,1198,1057,594,816,1429,1283,1317,1269,1034,669,790,1278,1466,1386,1362,1025,603,900,1293,1350,1230,1146,945,584,727,1158,1174,1241,1215,945,557,643,1067,1103,985,1069,888,603,702,1058,1083,1005,1029,814,450,530,794,1094,1062,1053,794,523,673,1044,1183,1137,1132,1027,637,688,1218,1225,1183,978,827,460,527,878,991,936,937,762,488,535,1008,849,869,905,679,486,504,898,919,922,825,559,395,437,856,861,827,863,728,424,444,891,923,881,885,701,394,480,882,866,865,779,679,394,440,876,876,857,841,709,387,371,686,768,858,724,646,384,468,703,734,688,715,530,348,407,767,903,747,736,664,402,457,680,881,962,907,761,524,541,905,1200,1112,1153,1134,620,918,1372,1527,1428,1378,1175,645,991,1457,1599,1521,1407,1209,697,961,1559,1645,1543,1494,1181,556,978,1474,1419,1595,1686,1453,889,1218,1670,1800,1692,1468,1243,783,1019,1502,1691,1631,1570,1286,830,1217,1788,1671,1836,1883,1423,797,1023,1831,2098,2017,1890,1254,702,925,1562,1600,1263,1402,1287,721,1056,1673,1632,1613,1519,1211,771,1169,1680,1694,1631,1623,1337,981,1214,1585,1560,1334,975,894,828,1086,1721,1672,1783,1686,1243,838,1055,1464,1462,1433,1315,1090,689,960,1309,1313,1230,1124,915,591,616,886,770,620,421,562,526,466,707,700,726
2009,646,796,727,845,1322,1339,1359,1215,1319,833,1070,1420,1399,1547,1445,1427,815,920,1310,1594,1526,1344,1179,850,1008,1422,1605,1660,1518,1221,803,1098,1495,1782,1441,1681,1422,875,1072,1695,1720,1514,1511,1244,644,951,1423,1501,1520,1626,1254,832,991,1514,1617,1528,1564,1227,778,1059,1603,1625,1579,1423,1267,674,985,1559,1469,1478,1529,1113,670,900,1420,1350,1350,1274,997,753,865,1269,1453,1242,1336,1099,707,888,1303,1294,1321,1413,1055,699,821,1275,1341,1382,1164,904,632,660,1267,1398,1333,1336,1294,651,882,1429,1462,1366,1234,1098,718,890,1409,1426,1273,1208,964,648,764,1174,1304,1211,1205,1071,642,810,1236,1308,1341,1235,957,641,789,1225,1276,1273,1101,933,600,665,1010,1147,1090,1163,911,570,650,1213,1239,1201,1129,928,501,652,1086,1126,1186,1048,779,535,626,1102,1201,1062,984,791,540,619,1052,1243,1172,1160,863,540,680,1255,1156,1175,1074,749,491,507,1012,1038,983,924,812,515,574,992,1089,1028,1082,943,581,589,991,1036,987,997,895,566,528,1039,1153,1082,1055,786,520,548,896,1079,1017,911,792,460,541,1045,1064,953,881,919,578,658,1026,1093,1073,977,889,543,673,958,1042,1132,1194,948,635,833,1234,1246,1342,1421,1157,646,785,1107,1450,1502,1534,1184,730,1010,1630,1614,1720,1643,1290,805,1074,1507,730,1010,1630,1614,1720,1643,1290,805,1074,1956,1676,1145,1319,1876,1821,2039,1773,1662,1036,1377,1946,2247,2154,2247,1729,1093,1235,1947,1845,1750,1786,1430,914,1060,1837,1904,1847,1742,1290,788,1021,1530,1879,1881,1808,1498,930,1397,1947,1831,1758,1812,1585,893,1110,1802,1645,1687,1490,1340,826,886,1373,1403,1102,974,976,867,964,1551,1669,1571,1614,1477,1073,1290,1694,1645,1596,1459,1563,981,1049,1267,1224,1284,1374,1296,838,841,1190,1003,982,669,534,697,664,802,953,1053,824
2010,721,828,1019,1216,1384,1497,1594,1397,974,1046,1552,1485,1503,1350,1247,878,1001,1290,1492,1451,1550,1305,1229,1229,1503,1623,1773,1709,1450,929,1114,1800,1871,1826,1675,1528,921,1142,1531,1762,1643,1744,1298,713,844,1188,1359,1464,1404,1276,782,1040,1564,1608,1519,1304,1179,877,958,1323,1463,1523,1521,1257,752,897,1393,1518,1476,1423,1428,875,1002,1310,1378,1437,1345,1206,805,936,1313,1413,1336,1315,1168,788,889,1291,1256,1315,1259,955,842,796,1121,1369,1447,1342,1064,714,843,1325,1389,1313,1314,1288,723,902,1372,1349,1273,1334,1122,833,896,1299,1398,1450,1377,1190,755,949,1342,1341,1317,1254,1285,728,882,1216,1302,1304,1165,924,788,915,1196,1056,952,1220,1248,804,903,1236,1348,1377,1223,890,721,740,1003,1074,1131,1171,1130,764,856,1087,1104,1092,1031,880,1116,1100,1058,984,861,937,865,677,750,1010,1026,1089,953,818,588,625,847,1024,936,921,823,498,514,606,980,934,980,934,596,574,833,839,893,865,810,604,603,849,857,809,1042,1158,752,808,1318,1192,1179,1172,938,618,727,1149,1181,1184,1182,985,641,768,1208,1369,1275,1226,1028,1651,742,1196,1108,1312,1198,1181,735,803,1149,1243,1407,1280,1043,828,859,1346,1516,1490,1495,1201,749,858,1291,1680,1621,1586,1212,846,1040,1718,1700,1762,1589,1436,909,1145,1775,1833,1851,1741,1404,977,1292,2088,2038,2003,1885,1432,968,1413,2034,2167,2047,1868,1465,976,1087,1774,2048,1999,2102,1597,1135,1362,2206,2136,2207,1978,1646,1081,1327,2016,1982,1942,1918,1653,1076,1299,1979,2029,2074,2066,1640,1097,1480,2218,2160,2079,1884,1677,1067,1286,1974,2012,1952,1964,1660,1175,1456,1988,1964,1854,1684,1518,1402,1721,7252,5083,2289,2247,1875,1261,1610,2287,2335,2357,2097,1818,1159,1341,1946,2014,1865,1797,1397,957,1100,1396,1444,1280,1135,816,748,878,1111,1053,1148,1069,900
2011,751,1045,1441,1665,1739,1771,1801,1110,1447,1948,1875,2105,1973,1584,1101,1286,1758,2117,2017,1944,1757,1262,1656,2284,2101,2048,1874,1365,948,1159,1836,1904,1793,1806,1363,1040,1103,1666,1843,2176,2106,1454,871,1066,1597,1734,1772,1727,1353,828,985,1580,1702,1667,1575,1444,899,1176,1710,1809,1689,1835,1363,869,1098,1666,1653,1532,1603,1242,808,961,1429,1552,1487,1393,1149,762,992,1447,1421,1480,1410,1131,743,957,1441,1509,1386,1490,1209,784,881,1444,1515,1514,1392,1201,704,893,1450,1493,1475,1427,1196,647,841,1414,1395,1338,1293,985,746,847,1340,1555,1561,1391,1022,729,866,1212,1308,1328,1323,1051,667,823,1251,1409,1401,1249,1148,691,815,1309,1250,1184,1098,1038,623,909,1271,1236,1197,1201,970,647,724,1048,1440,1379,1208,1008,635,725,1183,1319,1339,1313,1050,693,721,1149,1164,1156,1089,1086,692,739,1134,1252,1290,1143,988,631,751,1341,1135,1121,1086,813,643,720,924,1080,1214,1231,1088,706,704,1151,1207,1009,1062,917,619,683,1234,1270,1223,1297,1178,708,735,1090,1092,1089,1091,854,577,692,1113,1233,1176,1050,1011,645,689,1085,1056,1022,997,862,600,602,822,983,875,906,866,641,614,923,997,1090,974,964,708,792,1051,1108,1108,1188,1046,694,737,945,1221,1295,1323,1199,740,968,1394,1400,1507,1523,1333,947,1018,1558,1485,1488,1507,1305,804,995,1430,1456,1419,1631,1359,1062,1565,2093,1873,1771,1758,1574,1160,1201,1649,1717,1826,1823,1516,1095,1416,2263,2180,2326,2246,1737,1038,1233,1821,2028,2070,2182,1809,1318,1561,2136,1995,2166,2186,1862,1259,1598,2386,2267,2176,2103,1687,1261,1450,2140,2153,2285,2188,1805,1316,1407,2111,2052,1767,1516,1243,1138,1308,2028,2101,2102,2137,1806,1184,1627,2344,2388,2267,2119,1700,1238,1575,1994,2004,1918,1678,1343,1001,1137,1576,1383,1298,1111,1152,1152,1152,1096,1081,1150,1239,1075,854
2012,840,1290,1549,1789,1726,1433,1012,1256,1668,1656,1769,1793,1580,1125,1430,1903,2039,2113,1972,1723,1170,1398,1810,1899,1849,1743,1617,1079,1389,2053,2089,2130,2112,1840,1273,1396,1915,1992,2073,1997,1750,1243,1427,2025,1971,1857,1856,1510,1007,1238,1690,1834,1763,1819,1488,1082,1321,1738,1832,2008,1955,1554,1058,1305,1755,1911,1785,1700,1445,955,1086,1635,1633,1661,1736,1449,1009,1089,1767,1834,1490,1372,1125,656,966,1524,1537,1563,1426,1125,704,876,1311,1371,1287,1205,890,734,767,1160,1382,1328,1365,1134,719,924,1442,1542,1505,1440,1154,852,912,1459,1574,1510,1414,1171,717,979,1442,1572,1699,1554,1382,971,1116,1529,1573,1503,1441,1173,841,897,1572,1620,1579,1438,1260,879,1057,1549,1579,1616,1531,1418,1012,1063,1492,1903,1673,1444,1244,845,930,1368,1653,1486,1365,1163,818,1042,1643,1509,1426,1364,1171,842,970,1482,1636,1610,1708,1285,941,961,1383,1408,1404,1489,1227,919,1037,1395,1386,1239,1384,1226,969,973,1434,1516,1484,1479,1179,904,950,1369,1499,1464,1441,1185,751,944,1392,1477,1410,1393,1147,730,751,1257,1311,1265,1258,1070,846,846,1264,1348,1294,1150,1107,849,830,1227,1292,1242,1172,1122,756,834,1228,1286,1331,1353,1191,799,973,1513,1520,1551,1541,1284,894,993,1364,1804,1941,1874,1507,1044,1114,1776,1817,1773,1810,1346,871,1202,1828,1793,1877,1885,1473,1116,1515,2017,1946,1781,1581,1399,968,1291,1826,1896,2016,1859,1472,1287,1605,2368,2356,2276,2225,1863,1572,1627,2070,2032,2004,1884,1479,1114,1403,1911,1935,1906,1793,1523,1323,1563,2053,1944,1974,1837,1710,1333,1624,2108,2448,2029,2083,1698,1294,1419,1949,1941,1955,1917,1729,1207,1391,2148,1815,1590,1401,1205,1239,1533,2045,2234,2206,2147,1914,1391,1608,1917,1947,2107,2034,1602,1159,1357,1787,1934,2134,1900,1568,1033,1187,1474,1418,1427,1247,1059,936,1155,1027,890,1152,1216,1183,1091,1088,1177
2013,1102,1417,1599,1486,1242,1313,1693,1680,1764,1762,1529,1210,1401,1899,2234,2369,2398,1959,1373,1469,2157,2482,2607,2490,1972,1326,1518,2129,2325,2234,2089,1781,1036,1269,1904,1998,1976,2009,1604,996,1173,1913,1968,1987,1794,1538,926,1237,1797,2149,2259,2235,1717,1413,1652,2186,2402,2252,2138,1744,1223,1519,2300,2231,2170,2114,1675,1213,1376,2087,2145,2157,2105,1700,1193,1411,2157,2229,2105,2011,1688,1162,1394,1944,2071,1789,1407,1084,821,953,1500,1683,1715,1720,1375,943,1063,1675,1772,1910,1756,1510,892,1143,1702,1764,1714,1739,1437,939,1085,1688,1797,1836,1738,1379,879,1175,1742,1704,1615,1632,1368,911,1046,1707,1568,1483,1596,1405,1031,1000,1601,1715,1753,1573,1332,1017,1023,1557,1717,1803,1627,1342,789,782,1228,1624,1480,1645,1398,961,1072,1520,1451,1491,1480,1259,778,874,1546,1451,1603,1402,1169,718,794,1554,1575,1531,1391,1235,842,916,1495,1581,1528,1493,1190,868,860,1410,1608,1461,1254,1067,836,964,1542,1527,1590,1328,1116,748,809,1641,1703,1562,1644,1306,813,811,1439,1053,465,1146,991,614,743,1094,1135,1161,1014,913,676,670,1092,1230,1235,1101,898,709,722,1121,1088,1166,1040,896,682,731,1224,1170,1135,1140,1041,684,694,1216,1345,1338,1204,977,654,783,1059,1242,1246,1268,1179,862,971,1439,1625,1680,1601,1387,866,1135,1767,1978,1812,1732,1347,872,1036,1554,1624,1501,1595,1328,886,1087,1596,1855,1926,1773,1545,993,1299,1825,1768,1964,1895,1821,1102,1169,1901,1963,1986,1957,1683,1323,1450,2154,2242,2299,2300,2023,1360,1383,2023,2110,2121,1897,1455,1119,1425,2238,2340,2103,1972,1929,1695,1813,2382,2627,3080,2748,2135,1535,1729,2379,2646,2741,2287,1845,1304,1651,2317,2179,1794,1568,1271,1165,1350,1964,2021,2173,2277,1992,1503,1589,2119,2128,1862,1425,1307,968,996,1207,1219,1196,1085,860,631,677,818,707,633,692,747,660,663,800,835
2014,659,1033,1092,951,951,951,1684,1580,1677,1353,887,1068,1555,1653,1764,1633,1205,846,1010,1431,1662,1739,1890,1607,902,1165,1773,1900,1941,1726,1470,1059,1261,1696,1930,1857,1892,1557,924,1277,1830,1870,1816,1684,1326,800,1009,1723,1667,1787,1650,1378,838,1056,1738,1766,1678,1692,1366,843,994,1623,1685,1703,1515,1282,720,960,1528,1605,1497,1543,1152,772,917,1588,1523,1471,1426,1271,810,990,1582,1528,1537,1462,1180,778,947,1562,1540,1581,1541,1210,778,823,1445,1566,1483,1534,1231,784,758,1454,1626,1435,1294,1028,764,762,1313,1561,1518,1433,1188,785,969,1426,1533,1392,1406,1234,880,915,1315,1353,1436,1350,1171,715,874,1385,1447,1401,1330,1126,700,739,1221,1407,1460,1349,1107,700,780,1139,1525,1451,1281,1010,690,798,1490,1518,1472,1363,1079,717,849,1302,1481,1411,1283,1012,719,750,1265,1286,1437,1303,1096,648,744,1201,1280,1306,1196,1102,687,754,1164,1166,1224,1108,760,574,621,1189,1172,1231,1163,1024,638,761,1172,1257,1222,1212,963,650,633,1199,1205,1233,1180,975,624,639,1044,1065,966,1006,850,568,598,976,1064,1188,1209,1031,623,732,1261,1161,1075,1054,883,567,676,1076,1166,1192,1273,1081,671,758,1210,1253,1048,1137,1022,638,818,1071,1400,1558,1369,1192,722,898,1559,1748,1675,1673,1343,911,1205,1780,1715,1665,9308,1330,802,986,1627,1788,1708,1607,1286,829,1089,1835,1772,1761,1677,1448,888,1290,2148,2023,2101,1986,1592,984,1209,1878,1973,1895,1723,1344,812,977,1749,1819,1645,1629,1387,766,1015,1630,1768,1678,1659,1213,938,1264,2061,1882,1780,1869,1529,974,1252,1820,1909,2218,1966,1691,1063,1216,1971,2047,2128,1768,1521,842,1009,1697,1706,1393,1111,1012,810,788,1655,1947,1932,1650,1579,872,953,1642,1661,1562,1433,1123,683,826,1263,1239,1250,1138,875,558,552,799,849,625,491,551,541,615,890,903,806
2015,561,812,672,742,1269,1511,1628,1533,1275,797,833,1332,1349,1438,1517,1162,705,808,1285,1469,1535,13922,1224,752,821,1486,1539,1697,1550,1271,737,887,1497,1658,1649,1619,1283,729,879,1547,1651,1555,1579,1257,663,829,1463,1568,1473,1494,1177,694,815,1483,1489,1479,1351,1151,854,852,1393,1437,1409,1351,1160,692,784,1377,1436,1450,1372,1142,608,740,1321,1389,1382,1220,1080,698,770,1431,1269,1233,1164,976,558,734,1210,1286,1342,1179,813,695,765,1193,1364,1301,1258,1043,559,756,1217,1417,1257,1314,1042,559,741,1248,1288,1332,1168,961,585,737,1196,1230,1235,1125,950,539,716,1261,1222,1218,1273,1141,0,705,1238,1368,1224,1157,896,574,719,1115,1208,1213,1193,849,468,582,0,0,1246,1230,1037,663,690,1132,1141,1148,1115,946,558,614,1082,1150,1139,1091,929,456,581,1036,1113,792,738,562,361,488,631,666,713,713,560,388,329,648,760,797,703,464,325,384,696,767,665,668,580,337,342,659,770,668,685,575,337,439,781,715,642,618,552,348,337,613,700,729,600,561,380,397,679,892,895,745,631,394,390,636,740,760,769,602,360,439,746,784,864,744,706,347,350,681,776,784,816,744,399,456,781,924,963,864,783,424,437,777,1271,1155,1052,881,498,629,1132,1214,1065,1002,766,406,453,756,820,854,687,662,367,456,750,824,864,867,796,510,592,922,866,912,884,718,491,503,838,951,875,955,759,517,716,1034,850,904,859,743,449,569,918,938,962,898,693,417,463,858,903,1016,872,735,456,549,924,881,872,829,718,554,548,844,912,842,852,756,481,572,1068,979,864,708,535,454,569,944,1025,992,881,780,469,558,884,831,813,765,688,467,472,774,741,720,675,500,351,334,562,461,445,346,241,270,314,447,557,647,543
2016,327,419,449,749,936,797,805,668,407,456,817,794,835,838,646,502,563,817,907,887,847,700,482,513,851,866,811,750,725,463,455,800,816,885,847,646,419,415,711,856,714,759,666,422,456,708,828,776,726,606,408,427,772,813,779,722,597,396,444,750,705,779,669,592,357,403,613,717,741,714,574,357,363,633,682,651,633,620,306,375,628,631,664,576,388,312,322,559,631,667,616,533,338,419,630,728,723,673,582,373,403,711,776,687,703,589,377,435,914,772,692,668,585,337,391,752,783,713,659,608,303,360,661,728,661,629,524,318,389,679,695,641,598,500,308,344,546,625,634,652,559,324,377,633,717,711,706,615,381,433,600,782