2009,0,0,0,0,0,0,0,0,0,0,0,0,0,0,0,0,0,0,0,0,0,0,0,0,0,0,0,0,0,0,0,0,0,0,0,0,0,0,0,0,0,0,0,0,0,0,0,0,0,0,0,0,0,0,0,0,0,0,0,0,0,0,0,0,0,0,0,0,0,0,0,0,0,0,0,0,0,0,0,0,0,0,0,0,0,0,0,0,0,0,0,0,0,0,0,0,0,0,0,0,0,0,0,0,0,0,0,0,0,0,0,0,0,0,0,0,0,0,0,0,0,0,0,0,0,0,0,0,0,0,0,0,0,0,0,0,0,0,0,0,0,0,0,0,0,0,0,0,0,0,0,0,0,0,0,0,0,0,0,0,0,0,0,0,0,0,0,0,0,0,0,0,0,0,0,0,0,0,0,0,0,0,0,0,0,0,0,0,0,0,0,0,0,0,0,0,0,0,0,0,0,0,0,0,0,0,0,0,0,0,0,0,0,0,0,0,0,0,0,0,0,0,0,0,0,0,0,0,0,0,0,0,0,0,0,0,0,0,0,0,0,0,0,0,0,0,0,0,0,0,0,0,0,0,0,0,0,0,0,0,0,0,0,0,0,0,0,0,0,0,0,0,0,0,0,0,0,0,0,0,0,0,0,0,0,0,0,0,0,0,0,0,0,10,17,31,7,3,11,8,16,9,0,8,11,8,6,12,7,12,5,9,9,12,9,9,20,13,9,8,8,14,7,12,12,16,14,9,12,10,9,16,12,5,6,13,10,6,16,9,15,19,9,8,8,11,8,9,8,9,7,4,8,12,12,6,4,7,10,7,10,15,40,13,8
2010,16,18,1,5,20,14,23,15,22,38,15,20,25,12,28,16,15,16,6,16,21,22,23,23,14,8,8,24,33,18,13,20,14,12,6,12,12,11,11,8,7,6,8,6,12,17,12,11,8,6,7,8,11,5,12,4,12,9,9,14,7,6,6,7,15,12,11,18,14,15,17,11,26,19,22,19,18,15,19,12,12,13,23,28,17,16,14,20,16,13,15,17,17,25,16,13,16,14,13,11,14,19,19,14,12,23,22,18,21,14,26,12,20,12,13,17,14,14,56,22,21,18,11,14,12,20,29,37,10,20,9,17,12,11,24,14,11,6,12,12,11,24,13,13,21,10,13,16,13,12,18,11,14,11,13,12,9,14,11,19,11,17,14,11,15,15,19,14,15,20,15,14,15,12,11,17,15,12,5,6,8,10,7,9,15,15,9,10,9,10,7,11,10,8,9,9,9,11,6,9,8,7,25,17,17,16,14,15,17,25,15,14,24,15,14,12,12,26,14,24,14,11,23,16,11,5,11,15,14,15,13,25,15,19,15,26,15,8,8,17,16,38,19,15,18,17,12,20,10,17,10,15,17,11,12,11,18,10,9,13,7,9,12,14,15,16,12,14,14,15,20,13,18,14,15,7,19,10,16,14,10,9,12,17,18,68,44,38,31,20,24,29,17,8,12,9,7,13,13,15,14,14,9,24,18,16,14,18,15,14,14,17,14,8,7,11,11,11,13,12,11,10,8,6,11,8,10,9,16,10,13,15,5,8,9,11,11,8,17,17,20,16,16,14,6,12,8,12,14,14,15,9,7,14,10,7,11,7,10,8,6,9,9,9,5
2011,6,9,7,6,7,6,12,17,11,7,11,13,7,12,12,9,12,12,11,17,11,4,11,13,11,14,17,13,17,15,12,12,11,12,12,7,8,16,15,12,20,14,8,8,14,12,25,11,14,13,13,18,16,14,8,9,13,13,15,9,11,13,14,7,15,10,7,6,14,18,15,13,15,5,11,12,4,6,10,6,8,6,7,9,2,9,16,10,6,6,14,13,6,9,11,9,9,6,11,9,9,5,10,5,9,8,12,3,9,9,9,3,6,7,7,9,7,11,5,3,7,9,10,7,8,7,5,10,6,12,8,13,6,3,9,6,10,14,7,3,7,4,6,8,5,9,10,10,12,10,12,5,8,6,7,5,8,4,8,6,8,4,2,7,9,8,8,6,9,9,6,5,7,8,13,7,6,3,11,4,9,7,4,13,8,10,5,9,10,6,11,5,4,3,4,10,6,10,5,5,10,5,8,4,7,6,8,7,13,7,5,9,15,14,4,7,7,8,12,5,5,7,5,13,5,15,5,7,5,4,4,9,4,6,7,3,10,12,14,29,13,5,8,8,6,7,9,11,12,15,7,6,7,5,8,5,7,3,7,15,6,8,7,5,11,6,10,6,16,7,10,13,14,14,11,11,5,15,7,6,10,9,10,11,15,15,16,5,5,8,9,8,9,9,7,5,10,8,15,12,11,8,11,6,11,11,6,14,3,12,12,11,8,15,6,15,13,9,14,11,12,12,5,10,10,5,10,5,13,8,12,4,5,12,6,6,7,11,9,11,5,13,22,16,15,12,9,7,9,11,7,5,10,16,9,4,0,0,0,12,10,19,16,14,7
2012,13,12,12,5,12,9,9,13,14,17,6,15,7,9,12,7,8,11,13,7,22,22,11,8,7,10,12,5,9,11,7,9,5,7,9,10,14,3,9,9,5,11,6,3,7,11,17,13,12,11,10,15,8,12,11,11,7,5,4,12,16,12,12,6,10,12,7,7,8,13,11,13,11,5,5,10,10,5,12,6,4,12,9,10,6,6,10,8,14,6,8,8,10,10,9,9,5,10,10,56,11,9,4,7,21,7,5,17,8,10,9,14,14,11,16,11,11,10,8,5,7,16,13,16,10,6,9,44,14,19,8,18,9,16,11,14,8,12,15,13,13,10,16,10,11,11,6,12,12,15,21,10,11,11,10,7,11,15,14,9,8,15,18,10,21,7,6,8,20,15,15,17,10,12,11,10,12,27,9,9,9,7,14,14,16,12,9,8,12,7,17,9,16,15,17,16,18,7,12,12,14,14,10,12,13,22,18,13,11,9,11,12,16,14,10,14,11,15,5,10,12,13,10,16,9,18,13,12,8,13,7,15,10,14,13,8,8,17,14,7,7,8,11,12,8,8,6,9,10,8,9,9,11,10,11,17,8,6,11,14,22,10,14,13,19,14,6,6,7,13,8,14,10,7,8,6,13,16,11,10,8,12,13,12,8,7,7,10,7,16,8,11,5,7,10,14,8,11,18,20,13,12,19,18,8,8,8,20,15,20,11,11,12,6,6,12,10,14,10,9,23,15,9,25,13,12,10,11,13,15,10,10,17,7,8,11,21,12,16,8,10,11,8,5,6,13,22,8,7,5,10,6,11,14,9,9,12,66,7,13,10,12,10,12,14,18
2013,10,12,10,8,7,13,12,12,23,8,15,22,10,38,12,7,16,15,5,7,12,17,10,11,15,11,10,4,16,14,10,12,16,21,21,6,10,11,11,17,10,59,7,8,10,29,6,15,8,10,7,6,7,8,5,6,11,9,10,8,6,10,7,8,8,8,9,12,5,4,7,5,8,3,8,6,4,5,11,9,8,14,16,6,14,6,16,6,4,3,11,8,8,10,12,6,8,4,13,8,11,8,18,16,11,9,5,15,10,5,11,9,8,7,15,18,11,10,10,10,8,8,3,9,8,6,9,6,5,11,6,7,7,11,4,10,11,22,11,4,10,12,10,10,6,15,6,13,9,6,17,5,7,11,13,10,13,5,10,10,9,5,6,16,13,8,8,10,5,9,5,10,5,8,11,7,10,9,15,8,6,10,18,10,17,6,6,15,8,6,8,12,11,6,2,10,12,5,7,8,10,5,9,8,5,5,9,3,7,15,5,7,7,18,8,9,9,8,12,9,10,4,10,12,9,12,11,8,57,14,12,12,9,13,7,11,11,11,6,4,8,12,13,4,6,5,9,5,10,6,6,16,15,6,10,11,6,6,6,12,6,5,6,9,10,14,12,8,11,5,12,8,9,7,2,6,6,13,6,6,6,3,6,10,7,4,14,5,7,9,5,8,3,6,10,4,5,9,10,5,3,1,5,7,7,5,1,9,4,4,9,5,4,8,7,9,7,13,10,10,7,6,2,4,10,5,3,9,4,7,6,8,4,9,5,8,8,7,8,10,9,6,5,8,9,8,6,7,8,7,5,2,18,7,11,4,4,5,7,4,1,6,6,11,6
2014,8,6,13,3,3,3,10,9,9,6,8,5,6,12,9,10,6,5,9,4,11,9,6,9,7,15,8,10,8,6,5,5,5,8,13,16,7,9,3,11,6,8,9,5,11,7,5,35,6,6,9,11,4,11,12,9,12,10,8,13,16,13,7,14,11,14,8,9,11,14,12,11,12,11,8,17,9,18,22,12,17,14,22,18,17,10,9,22,38,28,8,13,12,10,11,16,18,29,25,14,18,20,26,13,18,20,18,17,10,14,10,19,10,15,13,25,16,31,15,17,17,18,13,13,9,15,12,10,10,8,10,14,19,23,15,14,13,14,14,20,17,16,15,14,17,16,20,19,13,13,15,16,17,12,10,12,9,14,12,10,11,15,12,22,19,18,13,9,13,13,17,11,11,13,10,11,23,11,5,8,6,10,21,7,8,12,11,9,8,7,14,11,20,14,10,11,12,17,22,10,4,13,12,17,12,16,14,20,23,16,16,16,5,18,8,10,13,14,7,18,11,13,12,12,25,19,11,14,10,12,17,9,16,10,14,11,27,12,13,19,20,17,18,13,7,11,12,11,12,6,12,16,9,9,15,5,7,9,15,16,10,12,17,19,17,8,16,8,11,11,17,11,14,8,10,9,7,10,20,7,21,6,13,12,8,13,10,9,8,12,3,19,13,15,11,13,8,12,8,5,14,8,14,8,8,10,10,10,11,17,11,10,15,6,14,13,9,9,15,11,16,8,9,13,14,9,15,6,8,7,5,8,7,5,12,11,6,13,6,6,6,4,9,12,7,14,13,6,12,7,10,8,5,11,8,8,15,3,19,21,17,10,17,21,15
2015,7,11,4,15,12,7,10,9,5,3,6,8,6,11,13,9,10,6,6,6,8,9,11,12,12,11,22,44,7,6,18,8,10,11,6,12,6,11,9,8,14,10,9,10,8,10,12,8,14,8,9,7,13,5,16,9,11,12,20,9,9,7,12,9,12,9,22,30,13,6,9,10,11,8,12,11,13,5,10,5,9,11,7,12,2,12,5,13,7,13,16,17,5,7,11,7,7,11,7,6,10,12,8,10,10,14,8,7,11,14,7,11,7,9,8,2,11,6,12,12,2,6,6,9,6,13,18,7,0,9,8,11,11,8,6,7,12,8,4,9,10,11,4,8,0,0,6,5,4,7,6,8,7,11,10,5,11,9,9,9,10,7,9,6,8,8,10,7,4,7,6,6,7,7,6,4,9,11,7,6,5,12,11,16,10,6,9,13,12,16,10,15,6,13,9,21,10,14,9,11,16,8,14,12,10,12,7,8,10,14,7,4,16,5,7,7,10,14,6,7,16,16,14,2,10,3,10,8,10,10,11,10,7,7,5,3,8,11,5,4,7,8,3,20,6,8,9,11,7,10,8,8,7,9,9,5,7,8,14,13,8,9,9,13,2,7,6,11,8,17,4,8,8,12,7,9,8,16,13,14,18,9,12,7,8,10,10,9,16,7,7,15,10,14,6,11,4,11,6,13,8,10,3,11,5,11,13,7,5,2,8,3,10,7,3,8,4,6,2,4,12,9,4,7,4,3,5,7,9,8,3,7,5,3,5,9,6,6,7,5,3,5,6,9,4,4,4,1,6,8,6,5,9,3,4,9,10,11,9,9,7,5,8,3,6
2016,5,5,3,5,6,2,6,8,5,3,7,8,2,5,4,1,4,5,2,3,5,8,8,4,5,5,3,5,8,5,4,5,5,3,5,4,1,3,4,4,3,12,1,4,3,7,4,3,2,12,5,7,2,5,3,6,7,3,9,6,6,11,4,9,4,4,5,8,7,5,9,5,8,4,4,6,12,5,4,10,9,7,4,4,5,6,9,5,7,7,8,6,2,2,2,7,9,6,8,4,2,6,10,2,3,2,5,3,3,8,0,5,4,3,1,7,3,7,3,4,1,4,3,1,3,1,5,10,2,2,4,3,5,7,3,2,10,6,13,7,3,7,4,3,6,3,6,6,3,7,6,10