2008,36,44,34,36,24,44,22,31,26,34,29,33,29,25,27,33,33,23,29,31,33,32,38,35,32,33,32,29,34,36,28,30,38,24,37,27,26,30,39,36,37,39,45,37,29,33,38,21,30,37,36,45,36,32,39,43,34,36,38,34,29,27,53,56,49,43,60,34,29,34,34,36,35,41,40,38,28,31,46,48,51,34,26,40,50,50,41,49,36,31,54,46,43,39,48,33,44,40,41,45,50,34,39,42,52,45,47,53,48,37,38,42,55,43,38,37,44,39,52,44,44,41,43,43,35,48,43,47,30,33,23,51,34,46,51,42,39,22,36,37,38,40,46,27,32,29,41,33,49,35,39,28,44,43,44,46,40,34,31,37,30,37,40,31,45,24,27,30,35,41,32,35,28,27,26,46,22,35,47,36,24,65,41,25,32,31,23,31,34,31,37,39,36,37,34,22,38,20,32,28,27,31,23,22,33,39,31,33,22,28,41,33,22,38,36,23,40,25,24,31,35,25,29,23,27,33,29,32,18,24,24,39,22,38,30,23,29,26,27,27,36,26,32,49,39,37,40,39,46,33,38,45,30,43,45,49,33,39,40,49,54,59,44,31,34,43,44,45,46,31,114,49,29,33,34,39,40,34,36,55,53,51,43,33,30,42,43,38,45,40,55,40,35,32,51,60,54,30,46,48,46,48,43,42,35,37,35,47,38,44,38,33,33,52,31,24,39,27,38,21,40,42,32,41,35,51,50,36,35,45,31,41,34,23,31,46,39,30,28,20,40,37,43,34,29,27,30,34,30,50,41,35,44,24,25,13,22,32,21,23,17,21,21,22,21,27
2009,29,32,44,30,46,37,31,36,25,36,33,35,21,35,45,49,39,36,49,35,36,34,32,39,27,31,39,55,66,44,47,32,45,33,29,27,31,36,30,39,36,38,38,39,26,36,36,59,34,32,39,29,31,38,43,47,51,35,43,45,45,62,34,49,37,39,52,24,39,35,37,35,24,38,23,26,22,32,23,30,26,26,29,33,32,21,21,40,29,36,24,23,36,29,24,26,24,31,25,28,36,27,30,27,26,36,39,26,33,18,24,27,20,30,37,21,32,21,26,20,28,21,30,17,40,26,50,30,27,28,31,30,22,34,38,27,40,36,29,33,31,32,30,22,27,35,26,25,29,40,34,32,34,30,25,29,25,43,29,28,26,33,32,38,29,24,31,25,25,23,16,37,43,21,25,32,28,21,31,26,64,34,21,18,28,32,28,28,19,30,21,23,17,18,27,23,23,28,22,18,26,18,26,24,25,29,20,29,20,32,25,20,18,21,23,20,27,28,34,26,18,39,18,24,22,17,20,28,25,23,36,35,30,32,43,28,40,30,39,27,35,34,27,33,26,30,31,36,32,24,33,36,30,25,27,28,39,42,37,37,33,30,32,30,27,28,39,42,37,37,33,30,32,26,35,50,33,43,46,34,36,45,33,35,31,28,37,28,47,30,37,33,35,27,36,28,30,27,35,36,37,33,30,40,29,41,33,32,31,23,33,47,39,40,35,32,35,36,45,40,35,32,18,25,20,21,20,22,12,20,18,27,17,24,13,18,22,18,12,31,14,16,18,26,16,23,20,19,53,15,15,18,30,28,16,21,15,14,24,22,23,18,86,22,21
2010,43,27,20,31,23,22,20,22,69,13,11,16,22,23,23,23,23,16,18,17,18,22,25,25,22,18,18,15,9,16,21,15,8,8,19,27,31,17,21,30,22,22,24,14,29,16,11,19,23,17,19,18,35,31,28,17,21,37,21,27,17,23,22,27,22,30,35,47,36,34,26,33,25,35,27,28,20,13,29,16,26,21,27,24,28,32,24,20,29,22,26,21,29,20,22,23,20,32,28,27,30,27,21,45,21,35,20,49,24,31,30,26,30,24,22,25,28,25,30,22,33,19,42,26,26,29,23,29,28,18,23,28,20,23,25,24,22,14,27,29,27,25,23,24,22,15,18,18,20,22,15,26,21,28,26,21,26,32,15,16,17,24,20,17,20,17,23,23,22,15,27,20,21,21,16,20,15,17,13,20,60,19,12,15,24,23,13,17,13,17,12,12,14,15,11,18,21,15,21,23,20,21,21,30,21,29,18,32,22,30,22,22,19,26,36,32,25,25,18,16,19,22,28,33,30,25,25,23,21,26,34,21,14,20,20,23,17,33,18,11,17,27,23,24,20,26,31,22,16,19,27,26,12,18,21,19,17,18,38,25,21,22,18,19,16,21,25,28,21,121,34,19,28,13,17,22,28,22,18,23,25,19,15,28,24,30,28,23,17,19,33,29,25,20,31,17,26,26,22,28,26,17,23,18,15,30,25,25,23,16,16,21,18,31,33,19,20,27,30,16,27,23,50,22,26,18,24,18,23,20,21,26,22,21,23,27,18,16,40,27,23,22,25,29,40,14,19,23,34,15,17,19,22,13,19,17,16,7,21,25,21,15,13,20,26
2011,16,18,12,26,26,29,24,23,26,42,26,17,27,18,21,14,30,16,24,10,24,22,25,24,27,24,27,38,20,27,28,26,28,26,23,26,20,26,24,27,18,40,23,27,14,28,37,26,29,31,24,17,16,19,17,35,15,27,35,22,27,35,32,21,26,27,26,27,17,20,21,25,24,30,21,32,23,26,28,24,22,19,15,18,14,12,20,22,25,26,21,27,19,21,19,20,23,16,22,23,18,29,24,29,18,16,16,17,21,17,25,22,19,21,13,21,22,15,16,15,12,10,19,16,22,25,30,12,18,9,24,15,19,20,9,22,17,18,14,16,18,6,21,12,20,21,22,20,18,6,12,16,19,16,14,15,28,19,26,14,11,28,20,19,20,24,13,20,10,23,14,10,23,16,16,15,9,20,17,12,17,19,13,10,22,21,11,22,22,19,16,15,13,19,17,13,11,9,13,7,10,10,12,11,19,22,15,15,17,21,17,10,12,14,16,10,29,10,15,14,16,7,30,24,22,20,14,13,22,21,13,9,12,13,13,14,27,16,15,14,14,14,12,15,22,31,19,9,14,16,20,18,24,20,16,11,9,13,18,8,16,15,17,23,15,29,26,23,14,27,24,25,22,20,31,23,23,21,25,18,24,30,21,31,25,25,30,22,15,23,16,24,26,15,14,20,26,25,20,23,16,15,22,25,24,26,18,17,13,21,31,26,23,23,16,17,21,21,17,18,34,13,15,38,10,35,39,26,24,17,15,11,18,25,18,28,20,28,17,15,9,29,17,26,15,18,32,31,19,58,16,21,16,20,16,18,24,24,24,21,18,14,16,11,24
2012,23,16,25,22,20,21,21,13,20,24,19,22,30,12,20,14,29,12,16,20,20,19,18,21,15,18,19,17,56,20,24,20,17,19,18,18,15,25,30,23,25,16,19,15,21,27,24,17,17,23,21,12,25,30,12,57,29,23,26,22,36,22,12,23,17,18,22,16,14,20,26,20,21,25,27,18,18,27,29,29,20,21,21,14,58,12,21,16,13,14,14,8,18,16,22,14,13,15,15,22,24,11,25,17,23,11,17,17,15,32,17,19,19,18,19,14,15,19,23,20,14,20,19,20,19,18,20,22,20,27,21,13,20,8,21,32,30,22,22,20,30,23,13,19,14,18,15,21,20,17,16,20,30,16,21,20,14,14,15,10,9,14,19,23,26,14,18,23,16,26,20,22,13,20,14,28,11,25,24,14,20,24,18,20,15,27,22,13,21,22,15,21,27,28,20,33,19,24,25,31,19,24,16,17,23,28,24,16,25,14,17,25,18,20,15,28,15,17,16,20,17,18,17,22,9,18,22,13,20,12,14,18,15,23,23,25,19,21,26,20,22,19,23,18,21,21,21,18,19,25,22,20,21,18,28,18,11,16,25,28,14,22,20,16,19,17,19,19,17,30,23,19,15,16,27,25,20,17,26,24,30,15,14,18,18,14,12,20,19,22,15,22,19,15,21,23,18,23,14,18,11,31,23,22,31,23,28,15,19,22,37,23,32,44,28,39,22,24,30,23,18,23,26,24,17,17,18,19,13,27,21,23,33,19,15,17,27,16,18,30,22,23,20,28,20,19,13,24,13,14,18,24,9,18,29,27,22,16,25,13,12,15,20,16,18,27
2013,17,23,18,20,11,23,15,36,25,21,18,17,22,17,25,23,18,13,10,25,12,24,18,16,24,19,16,22,26,31,19,23,17,14,23,14,25,18,25,16,17,20,18,15,15,22,16,20,18,31,14,17,15,26,32,25,61,28,18,44,49,15,19,21,22,27,26,28,16,25,24,15,29,22,17,26,20,21,21,22,20,21,19,24,33,20,30,10,19,27,18,18,9,23,15,23,23,20,22,14,15,24,19,12,38,26,24,39,31,31,26,36,34,45,16,25,23,15,22,22,30,19,21,25,20,28,19,45,36,22,24,26,31,22,31,34,22,19,18,13,21,25,28,24,19,13,18,20,31,20,19,17,23,18,25,20,23,24,11,22,19,19,20,23,19,19,21,24,19,23,27,13,18,12,10,20,15,26,20,12,25,18,28,24,29,23,18,30,19,13,19,15,19,10,12,12,17,14,19,32,11,26,18,13,9,19,8,17,15,20,20,8,22,16,25,22,22,16,17,17,26,19,15,21,16,15,21,16,17,18,23,26,14,20,17,17,14,15,22,14,5,9,13,10,20,13,12,21,10,14,17,29,19,20,21,20,24,22,15,16,24,12,17,18,16,28,22,12,9,14,28,16,25,14,24,14,15,22,15,15,14,19,24,19,21,9,13,10,16,21,19,14,19,30,16,20,23,15,19,19,31,22,14,17,17,20,15,30,8,19,19,20,15,12,16,17,23,23,22,15,28,21,22,12,17,20,13,21,19,15,24,20,20,18,11,19,15,24,28,24,21,17,22,16,14,22,19,24,16,9,20,24,26,20,16,17,18,24,9,15,20,14,19,18,22
2014,13,16,11,29,29,29,19,35,33,25,13,18,30,23,31,43,27,22,23,25,11,13,35,16,20,24,26,27,26,27,20,22,10,26,30,17,30,19,22,19,19,21,21,25,22,19,25,15,20,18,21,13,20,21,15,17,27,26,21,24,23,24,25,27,22,11,24,15,31,30,35,33,22,19,33,19,38,41,36,24,36,21,33,21,27,28,12,28,17,24,19,17,24,20,18,24,26,17,28,22,30,22,28,24,19,34,25,34,18,20,20,15,25,19,23,23,29,24,15,25,28,23,22,23,18,30,37,33,24,13,17,26,24,20,21,19,29,27,28,35,25,22,22,23,31,24,42,23,25,35,20,26,27,39,37,20,26,23,40,31,29,15,11,23,25,22,14,22,22,18,27,54,23,13,25,18,30,39,27,33,59,24,22,18,18,30,26,26,25,30,34,17,33,18,27,43,19,30,20,23,16,25,18,25,31,19,24,20,22,29,17,17,28,26,19,18,26,13,24,30,27,21,27,26,17,19,24,26,18,27,20,25,24,25,18,14,19,25,21,15,28,34,22,34,45,23,28,27,31,32,41,41,38,37,18,27,21,30,17,21,22,31,23,21,33,20,20,29,20,21,25,20,23,17,23,27,13,13,27,25,30,28,21,20,25,17,36,23,30,21,16,28,25,27,27,20,21,22,20,19,22,28,33,17,24,27,45,49,26,20,22,34,25,30,23,32,20,32,113,20,30,22,28,21,27,52,23,24,20,31,28,29,25,10,15,19,29,20,28,44,8,20,22,36,28,16,17,34,37,18,16,27,23,32,15,27,22,14,18,27,15,19,19,15,8
2015,31,21,20,28,34,33,17,24,19,20,14,25,22,26,26,12,10,22,18,16,15,28,16,18,19,28,33,19,20,25,24,18,29,23,28,24,26,22,14,27,26,23,17,29,26,19,20,25,25,28,22,18,15,28,28,21,33,26,21,16,25,31,33,26,40,12,26,27,40,31,24,36,26,43,30,36,34,30,21,22,24,33,24,30,34,36,25,26,23,19,23,57,25,32,24,18,29,38,21,23,19,26,20,20,31,29,12,28,27,27,41,15,21,25,24,32,51,28,23,34,38,32,21,44,29,25,35,33,0,35,26,46,42,24,28,34,42,20,27,26,28,31,23,31,0,0,31,40,28,29,45,38,38,32,36,22,32,31,18,31,26,30,16,16,12,25,12,11,7,17,18,12,33,8,11,10,9,15,8,11,37,17,19,17,21,10,24,15,19,22,21,11,12,18,23,15,26,17,17,24,38,13,16,22,19,18,20,10,24,27,14,15,21,17,18,18,22,21,33,15,13,14,14,26,16,16,13,17,16,13,10,12,16,23,10,18,27,22,14,25,17,13,11,15,18,30,18,18,22,38,71,26,12,15,17,11,17,19,14,46,15,16,12,28,18,18,25,22,11,14,16,16,14,16,21,21,16,11,19,18,14,16,11,12,20,26,15,28,17,16,19,18,26,17,24,28,13,14,14,26,24,15,11,23,16,16,23,8,23,11,17,21,20,11,16,30,18,15,13,15,13,11,12,13,10,11,18,15,9,12,14,13,6,14,15,6,7,12,7,16,9,8,13,15,15,6,9,10,19,6,7,14,5,9,8,5,7,6,1,5,11,6,6,3,12
2016,4,9,8,11,12,7,12,9,10,10,7,12,11,8,7,5,4,14,7,10,8,9,6,9,6,15,4,13,12,8,11,9,9,5,19,13,11,8,12,16,9,16,20,9,10,8,11,15,14,11,18,17,11,6,5,8,4,12,7,5,8,10,16,7,9,4,10,5,4,10,7,9,9,20,14,15,10,6,4,8,16,7,11,4,11,9,9,9,8,4,12,13,8,6,10,13,10,9,13,6,12,12,13,10,13,10,3,8,8,13,6,10,13,7,14,6,7,9,10,11,6,6,9,8,8,6,8,9,3,15,3,10,9,14,7,4,10,7,9,6,10,4,4,5,12,12,7,9,7,4,14,22