2008,21,8,18,16,14,18,14,18,25,31,31,16,16,20,21,24,27,66,39,41,120,116,89,49,49,27,29,40,49,44,25,25,27,18,40,137,92,57,59,31,17,22,31,42,48,25,18,16,28,21,30,28,33,12,14,36,34,32,27,32,36,29,29,30,26,31,31,13,19,24,34,23,12,30,15,20,22,33,35,27,16,23,29,23,30,22,32,27,13,16,43,21,33,16,38,31,14,32,33,25,23,16,22,19,53,27,22,34,23,17,24,28,35,40,13,34,12,26,31,39,25,33,35,14,11,34,28,30,23,34,19,17,36,26,33,23,27,11,20,29,26,24,21,34,16,15,19,26,38,10,13,21,24,17,33,22,35,15,27,21,16,28,32,33,6,25,20,30,21,40,41,25,13,32,20,28,29,22,20,12,16,38,20,22,14,18,14,10,27,21,19,16,16,17,25,34,29,20,38,24,13,35,21,17,24,25,25,19,11,19,25,27,24,19,10,11,18,16,21,25,16,13,7,20,15,21,9,29,10,9,14,24,36,13,44,16,15,18,23,18,13,14,12,8,11,32,17,29,19,10,17,17,23,18,16,12,14,18,27,29,32,36,31,16,19,27,39,43,30,21,11,17,19,38,27,42,27,14,27,35,45,43,54,39,19,25,59,89,64,40,30,52,50,43,52,46,45,40,36,34,50,53,27,28,37,18,41,34,56,36,75,88,62,51,43,60,39,62,28,30,34,34,29,31,26,45,58,69,124,64,37,28,26,35,32,34,55,31,37,24,38,41,21,26,51,22,28,22,30,29,35,38,33,29,22,17,41,28,28,17,12,13,13,20,37,15
2009,15,20,31,22,15,28,22,20,33,21,15,37,30,27,28,35,23,18,26,40,41,44,20,19,21,29,38,29,28,29,37,38,32,47,44,14,32,16,15,38,36,26,29,28,30,16,33,28,48,20,20,28,14,29,36,39,24,38,29,36,39,52,43,22,37,28,24,35,50,31,48,34,48,45,51,45,35,25,45,25,28,27,36,38,41,29,21,40,36,32,29,48,27,44,31,44,53,27,26,37,21,22,26,34,36,30,18,27,41,33,26,27,54,31,26,34,27,38,43,50,30,24,16,49,35,40,36,38,28,16,60,43,36,35,53,24,29,33,25,30,38,26,30,49,29,60,26,46,23,33,29,33,24,50,42,39,21,23,64,40,44,33,36,13,15,32,41,45,36,30,14,30,43,66,38,43,29,23,31,22,27,34,37,50,15,30,74,83,49,44,42,13,31,44,38,47,61,39,36,26,26,83,53,80,49,43,31,79,69,55,43,57,27,25,31,40,32,32,34,27,39,65,50,39,54,28,32,33,51,55,40,41,34,23,23,43,50,64,40,39,43,36,27,36,39,42,37,19,38,42,32,39,43,35,30,43,52,40,39,52,38,23,24,31,30,43,52,40,39,52,38,23,24,50,52,19,37,42,49,39,39,51,27,47,32,54,53,54,19,32,34,46,49,43,48,29,20,69,39,41,51,36,30,29,41,32,33,49,53,53,51,25,81,56,28,35,34,22,28,36,42,50,44,37,29,49,28,69,24,18,32,29,23,44,40,58,32,42,18,31,46,39,26,27,39,26,36,40,43,51,52,53,87,34,44,49,42,34,18,32,31,40,32,32,27
2010,19,28,19,31,28,28,27,41,34,29,42,44,34,26,26,29,33,30,29,42,42,48,50,50,34,44,30,40,60,26,72,22,44,40,41,43,22,23,23,20,46,51,37,32,47,60,43,45,25,22,40,53,54,59,53,59,40,61,47,24,36,31,32,44,39,30,47,43,45,36,31,43,38,46,52,66,58,51,32,36,59,31,85,57,36,50,34,38,51,36,49,40,33,32,37,38,50,42,59,37,34,33,21,41,49,30,40,65,57,40,27,41,57,42,37,64,42,50,37,52,30,41,47,48,76,59,54,53,28,58,53,47,24,33,43,45,34,30,27,30,28,43,23,31,28,29,32,33,36,32,25,41,27,26,28,40,24,28,36,40,24,31,29,32,42,30,19,37,24,23,25,36,23,25,21,28,27,27,21,24,37,41,32,8,25,21,29,26,29,26,18,10,20,25,27,38,36,24,22,18,18,25,49,40,34,37,34,45,44,39,38,30,24,57,39,48,38,42,27,40,40,58,53,56,51,37,43,30,34,47,29,33,38,22,39,44,35,47,48,34,33,32,44,42,50,35,36,33,47,33,35,44,41,37,30,35,27,42,34,32,25,30,27,48,86,46,48,40,34,65,47,47,55,37,31,38,41,39,49,56,48,49,31,54,52,66,35,49,38,43,60,42,41,38,40,40,23,42,41,41,48,38,54,31,34,53,45,42,32,31,26,63,44,56,72,49,43,24,31,50,34,40,41,33,31,53,64,59,41,42,32,20,49,38,40,49,47,27,39,53,49,42,50,48,46,36,48,60,51,40,40,27,43,45,35,50,26,39,24,25,30,33,35,28,22
2011,51,22,30,30,42,29,62,31,34,39,27,59,47,50,30,30,40,41,57,34,31,26,43,37,31,53,38,53,58,39,45,30,47,44,43,27,33,43,31,44,57,42,26,33,33,41,31,29,40,36,37,29,47,34,39,26,21,31,48,30,61,46,34,26,37,38,34,61,43,45,27,59,35,32,43,46,52,36,26,33,61,45,55,56,30,29,42,54,52,38,35,23,25,28,51,50,52,33,38,35,43,53,45,68,57,29,38,50,70,47,43,31,29,37,37,51,51,58,37,29,50,22,50,53,51,45,25,31,44,37,47,50,50,31,83,179,142,135,223,187,68,93,92,90,76,80,86,40,51,67,54,47,40,52,30,34,50,62,45,46,146,90,164,103,112,86,64,40,36,22,61,40,97,40,23,34,32,64,93,131,68,58,38,32,45,57,46,59,46,33,34,56,41,31,54,50,26,41,41,62,70,71,51,49,30,52,47,47,51,47,32,55,44,58,60,59,41,61,35,42,52,43,61,34,39,58,53,48,37,39,40,51,41,38,54,48,47,41,39,32,51,39,37,38,25,32,30,39,43,41,45,46,56,50,38,50,34,54,62,47,32,34,48,67,54,49,50,47,46,38,54,45,65,52,28,45,71,65,43,40,34,51,45,59,42,61,47,47,43,43,76,48,58,69,22,32,59,51,77,54,49,47,38,73,47,82,72,53,40,52,72,76,75,57,55,48,44,75,65,75,75,58,51,55,48,69,65,72,98,64,40,62,57,71,70,55,54,55,51,66,51,68,58,47,53,65,57,53,48,45,37,49,53,42,44,42,0,0,0,17,39,32,53,40,28
2012,23,44,49,51,63,42,42,49,46,67,47,63,49,39,49,50,63,64,72,56,32,48,62,51,69,68,60,57,39,67,56,52,63,53,33,52,43,65,80,48,37,39,41,56,49,67,77,72,38,36,65,58,67,63,40,53,48,57,54,104,104,103,93,96,104,96,103,102,109,86,108,92,115,106,92,107,84,87,86,52,70,52,138,109,80,85,70,83,70,50,39,58,48,47,51,44,36,33,27,55,49,54,58,55,52,59,115,176,139,113,68,71,81,85,98,71,96,67,59,53,62,50,70,58,66,45,85,59,61,66,55,64,33,50,49,51,83,54,59,30,39,71,48,64,67,70,63,48,40,53,51,47,70,44,34,56,51,73,69,54,32,54,151,80,83,69,65,46,42,70,78,97,68,72,34,37,48,52,48,37,52,46,33,64,56,50,56,45,55,22,50,55,43,43,52,34,36,57,47,57,49,26,31,33,58,50,56,63,47,44,37,68,71,40,44,43,65,51,42,52,54,43,43,42,42,58,42,47,39,53,37,32,38,39,63,48,45,41,38,53,57,49,42,53,38,32,61,52,198,329,184,80,76,93,91,83,72,63,44,72,68,41,74,67,67,58,53,98,72,63,95,61,57,64,63,94,87,73,69,72,43,69,92,62,82,700,85,92,84,104,63,70,54,41,41,78,75,69,71,59,53,52,62,76,53,64,68,45,83,113,87,149,71,80,88,61,93,66,61,71,80,59,48,81,52,84,48,78,84,60,79,83,95,62,60,108,78,118,80,61,65,78,58,124,88,90,83,57,70,87,63,80,74,122,61,48,42,151,85,64,56,62,46,42,27,38
2013,42,46,64,53,129,59,70,61,80,49,64,44,39,70,77,68,96,65,52,65,79,54,66,63,61,46,50,74,86,81,105,71,38,40,61,59,56,44,55,44,52,60,59,56,64,60,40,52,77,85,65,67,72,62,59,69,59,73,74,86,62,69,68,81,79,80,66,72,75,83,112,104,85,69,55,44,51,63,90,69,59,51,53,82,96,46,51,64,38,39,62,66,62,62,48,58,57,50,74,65,87,63,46,43,41,73,60,69,98,42,48,66,54,61,85,75,60,44,60,50,36,45,62,56,27,62,73,63,69,40,47,43,53,51,55,91,65,46,43,50,63,61,74,54,46,45,51,47,66,51,26,46,38,56,62,64,57,39,58,31,39,46,43,103,40,35,44,48,76,59,52,30,33,40,62,60,88,62,42,39,25,65,58,58,46,45,28,33,51,62,52,48,50,41,28,46,69,61,38,61,31,41,48,44,25,51,73,70,34,47,46,79,133,76,31,31,40,78,111,48,53,45,45,60,71,57,35,39,40,49,154,70,61,64,78,50,80,93,64,83,58,38,41,50,43,38,65,70,50,46,33,54,71,51,44,62,57,61,137,85,80,54,58,36,34,52,52,65,54,48,45,37,54,52,37,65,64,60,40,53,62,93,82,51,46,53,56,50,50,55,55,47,75,82,45,51,51,44,61,33,46,53,46,54,47,34,26,53,57,56,42,42,41,26,42,52,54,55,30,31,40,51,55,48,46,36,45,95,60,68,38,45,60,46,43,54,65,68,60,63,47,49,83,107,68,85,59,46,72,45,82,39,53,34,22,28,42,41,43,36,41,52,32,32,33
2014,43,40,47,50,50,50,67,54,60,80,50,36,41,61,60,73,56,33,48,47,41,54,62,55,42,52,66,54,69,57,62,60,46,56,49,46,54,61,39,43,60,74,68,51,52,38,44,64,49,73,39,42,38,34,36,71,51,42,53,37,31,38,50,30,54,58,35,35,40,51,56,64,40,34,26,43,61,41,48,33,37,30,58,73,48,46,62,29,44,39,55,55,38,58,43,45,49,66,73,63,50,31,34,33,43,36,56,49,26,39,58,49,33,42,37,33,37,48,60,55,59,34,41,31,68,55,49,51,50,41,37,48,50,47,42,61,40,49,62,55,44,57,41,43,28,38,48,53,55,46,39,34,59,46,40,38,43,32,37,68,61,40,50,43,37,51,36,42,46,46,35,38,25,46,34,43,38,46,46,20,51,30,30,35,34,20,36,47,36,46,38,47,32,33,66,24,47,49,34,27,40,39,44,26,69,47,32,36,47,37,35,46,32,43,62,117,75,59,63,37,32,38,49,57,54,38,53,39,29,48,42,44,40,32,40,33,46,46,30,46,34,30,35,72,48,41,48,34,37,30,47,50,47,49,34,34,125,89,54,43,33,46,28,32,44,48,59,45,44,30,43,46,44,38,43,27,31,40,39,72,44,56,45,44,43,67,52,49,38,36,32,26,40,42,29,28,35,30,23,31,42,43,34,42,34,32,32,61,29,28,38,22,52,35,48,40,34,53,77,49,47,57,50,34,44,34,37,34,38,37,23,40,28,16,48,54,44,23,40,27,28,47,39,19,31,32,50,37,33,22,37,37,31,22,27,30,25,23,19,52,31,13,23,37,17
2015,21,46,31,27,40,47,31,54,77,30,43,46,34,63,35,23,21,25,24,46,29,29,28,16,29,19,34,39,31,32,25,29,25,29,24,36,18,24,28,26,48,37,28,26,17,19,37,22,30,41,42,18,24,28,63,46,33,37,21,22,30,44,30,75,34,19,19,30,34,39,24,32,23,21,42,41,34,47,25,37,34,40,27,45,38,36,19,23,50,37,37,48,24,23,32,41,19,39,57,27,37,23,27,35,38,43,39,26,30,40,32,31,54,54,26,39,44,38,44,37,33,34,84,64,48,43,38,50,0,44,53,33,47,33,37,34,43,41,48,35,26,28,30,35,0,0,22,37,31,28,26,43,39,39,37,38,45,21,24,33,49,55,46,20,26,31,36,25,27,36,20,18,38,35,46,27,17,12,18,44,65,30,39,31,31,22,41,43,34,61,50,32,26,56,41,30,42,19,34,29,45,47,30,37,25,24,33,41,44,25,23,29,17,22,25,22,31,33,37,27,28,31,22,27,31,18,19,43,36,27,33,37,16,22,9,21,36,36,29,45,27,28,54,35,29,46,25,21,20,34,59,48,34,41,23,22,34,38,33,39,44,29,26,36,32,43,38,37,27,36,31,50,28,33,23,22,35,56,58,52,51,30,24,24,56,64,36,44,20,21,26,30,58,31,31,28,16,17,26,42,33,53,46,18,22,40,34,46,40,32,19,26,29,29,30,58,35,24,35,32,50,28,18,29,27,19,23,16,24,20,24,19,18,42,40,25,35,26,22,28,29,36,24,57,29,12,51,34,36,46,37,43,19,12,25,19,27,9,14,22,21,26,22,34,14
2016,13,19,18,34,23,23,24,37,27,19,20,29,26,33,38,21,18,27,30,39,38,26,22,24,20,36,30,53,25,18,24,28,28,17,36,27,30,14,27,36,23,34,22,24,21,21,40,36,41,26,28,31,36,42,43,33,22,13,21,24,37,31,34,18,15,20,25,32,14,25,19,19,17,30,35,32,46,18,15,17,29,28,19,32,26,15,17,32,27,21,21,19,14,25,26,32,23,23,21,24,16,40,48,36,31,32,19,29,34,22,24,40,32,30,17,26,31,31,26,25,16,17,28,24,10,25,27,43,25,45,30,33,36,28,24,23,26,41,40,31,31,28,23,19,21,26,24,27,23,17,27,27